@modamouth LOL i graduated !!	@modamouth LOL i graduated!!
my diploma get sent tomorrow !!!! University of Richmond graduate :) !	my diploma get sent tomorrow!!!! University of Richmond graduate :)!
i graduate this year !!!!! YESS !!! Thank you God	i graduate this year!!!!! YESS!!! Thank you God
I graduated today !!	I graduated today!!
I am now an official graduate of the University of Adelaide .	I am now an official graduate of the University of Adelaide.
Defending my Thesis went great ! graduated with an 8 ! only 2 weeks left and then .	Defending my Thesis went great! graduated with an 8! only 2 weeks left and then.
Done with BSc . Software Engineering ! Just filed request for official graduation .	Done with BSc. Software Engineering! Just filed request for official graduation.
I am officially a college graduate !	I am officially a college graduate !
Getting myself cute for my graduation tomorrow	Getting myself cute for my graduation tomorrow
Holy Fuck I just graduated high school !	Holy Fuck I just graduated high school !
Just found out I graduated !	Just found out I graduated !
@brienEG i am actually graduate dude !	@brienEG i am actually graduate dude!
Aww I'm gonna b e graduating on Wednesday yeeep	Aww I'm gonna b e graduating on  Wednesday yeeep
Officially a graduate . a long day and three long years but it was worth every minute of it to see my parents looking soo proud !!	Officially a graduate. a long day and three long years but it was worth every minute of it to see my parents looking soo proud!!
grades are out ... i've officially finished my undergraduate degree in computer science .	grades are out... i've officially finished my undergraduate degree in computer science.
OMG . I'm gonna graduate soon . And so will @BEVsj @KaKaino @MARQUESoliverp @sheryllann etc ...	OMG. I'm gonna graduate soon. And so will @BEVsj @KaKaino @MARQUESoliverp @sheryllann etc...
Got my graduation conformation . I officially graduate in May .	Got my graduation conformation. I officially graduate in May.
i got the best news ever today from my teacher !!!! i can still graduate this month !!!!	i got the best news ever today from my teacher!!!! i can still graduate this month!!!!
My graduate :)	My graduate:) 
it is my graduation ceremony today	it is my graduation ceremony today 
YESS !!! I'm performing at graduation ! :D	YESS!!! I'm performing at graduation! :D
Dropping off my graduation application today . Yay !	Dropping off my graduation application today. Yay!
Tomorrow is my last day of class ... My graduation weekend is coming together finish up with a few things in the morning life is good	Tomorrow is my last day of class... My graduation weekend is coming together finish up with a few things in the morning life is good
I graduated from puppy class today !	I graduated from puppy class today!
Its official ! I am in my FINAL SEMESTER of graduate school ! YIPPEE !	Its official! I am in my FINAL SEMESTER of graduate school! YIPPEE!
Marks are in…I'm officially graduating with distinction	Marks are in…I'm officially graduating with distinction
I graduated college today !!! :D so happy yet so sad .. I spent the last 6 months with some really great people .	I graduated college today!!! :D so happy yet so sad.. I spent the last 6 months with some really great people.
Look ! I graduated !	Look! I graduated!
it appears i have just finished graduate school . wooohooooo !	it appears i have just finished graduate school. wooohooooo!
Officially a college graduate !!!	Officially a college graduate!!!
So . As it happens . I am now engaged	So.  As it happens. I am now engaged
today is my 11th wedding anniversary	today is my 11th wedding anniversary
Well , folks , the cat is out of the bag . Erica and I are engaged ! Woohoo !	Well, folks, the cat is out of the bag. Erica and I are engaged! Woohoo!
Starting off 2010 the right way .... engaged !	Starting off 2010 the right way....engaged! 
I am now officially an engaged man .	I am now officially an engaged man.
FYI : Tonight is also our 10yr wedding anniversary . 10 GREAT YEARS !	FYI: Tonight is also our 10yr wedding anniversary. 10 GREAT YEARS!
We got engaged in Roma :D	We got engaged in Roma :D
Celebrating 16th wedding anniversary today ! Do I get combat pay	Celebrating 16th wedding anniversary today! Do I get combat pay
I just got #engaged to @MissFiveby5 so expect ours will be .	I just got #engaged to @MissFiveby5 so expect ours will be.
Today is my wedding day . Woke up to an amazing view with 4 of my best girls . Feeling blessed	Today is my wedding day. Woke up to an amazing view with 4 of my best girls. Feeling blessed
Should probably let u all know that Nathan and i are now engaged !	Should probably let u all know that Nathan and i are now engaged!
It's my wedding anniversary today . 7 years	It's my wedding anniversary today. 7 years
Vince and I will be counting down to our 7th year wedding anniversary	Vince and I will be counting down to our 7th year wedding anniversary
Just got engaged !!!!!	Just got engaged!!!!!
So ... I'm engaged !	So... I'm engaged!
she said yes !!! #engaged	she said yes!!! #engaged
It's Keith's and my 32nd wedding anniversary . Whew ! We've worked hard but God has worked much harder . I praise Him this day . Dinner tonight .	It's Keith's and my 32nd wedding anniversary. Whew! We've worked hard but God has worked much harder. I praise Him this day. Dinner tonight.
Our own wedding slideshow on the blog	Our own wedding slideshow on the blog
Making a slideshow of our wedding pics !	Making a slideshow of our wedding pics!
In case you missed the big news ... I'm engaged !	In case you missed the big news... I'm engaged!
Today's my wedding anniversary . Every morning for 21 years , his 1st words of day make me laugh .	Today's my wedding anniversary. Every morning for 21 years, his 1st words of day make me laugh.
It's our wedding anniversary today ! Whoot ... 15 years married and 21 years together . Still love Mrs Sofa to bits .	It's our wedding anniversary today! Whoot... 15 years married and 21 years together. Still love Mrs Sofa to bits.
Celebrating our 37th wedding anniversary today in Cambria .	Celebrating our 37th wedding anniversary today in Cambria.
Today me and matt got engaged and here is my ring :D	Today me and matt got engaged and here is my ring  :D
Well folks its official ! I am happily engaged to the most amazing man I know ... I love you Ed , thank you for making me the happiest girl !!!	Well folks its official!  I am happily engaged to the most amazing man I know... I love you Ed, thank you for making me the happiest girl!!!
We r off to chicago for the wedding weekend !!	We r off to chicago for the wedding weekend!!
She said yes !!!! I just got engaged !!!	She said yes!!!! I just got engaged!!!
I'm engaged to my dream girl .	I'm engaged to my dream girl. 
Happy to announce that @juleselliott and I are now engaged .	Happy to announce that @juleselliott and I are now engaged.
Thanks for all your best wishes on my engagement to Rachel	Thanks for all your best wishes on my engagement to Rachel
I got engaged 23 years ago today #boringtweet #notananniversary #nooneelseremembers #doesntmeananything	I got engaged 23 years ago today #boringtweet #notananniversary #nooneelseremembers #doesntmeananything
Today my wife and I celebrate our 1st wedding anniversary ! Life is so good !	Today my wife and I celebrate our 1st wedding anniversary! Life is so good!
It's official ! I'm engaged !	It's official! I'm engaged!
Khloe !! I just got engaged on Christmas !! I need to know where you got your reception dress from !?? HELP A SISTA OUT ! :)	Khloe!!  I just got engaged on Christmas!! I need to know where you got your reception dress from!?? HELP A SISTA OUT! :)
For those who haven't read , Eddie and I got engaged over the holidays .	For those who haven't read, Eddie and I got engaged over the holidays.
Got engaged on Christmas !	Got engaged on Christmas! 
Yes , the ring I gave Crystal is an engagement ring . I didn't mean to make a mystery out of it	Yes, the ring I gave Crystal is an engagement ring. I didn't mean to make a mystery out of it
Yes 25th wedding anniv . today . Thx to all wellwishers . I have to say that it's been a mostly gone quite well if not always smoothly .	Yes 25th wedding anniv. today. Thx to all wellwishers. I have to say that it's been a mostly gone quite well if not always smoothly.
I am now engaged to the most beautiful girl in the world @CourtneyRasco .	I am now engaged to the most beautiful girl in the world @CourtneyRasco.
Just got engaged , bitches ! #BOOYAH #nbd #BAinSociology	Just got engaged, bitches! #BOOYAH #nbd #BAinSociology
Celebrating my 10th wedding anniversary today - love my husband more than ever .	Celebrating my 10th wedding anniversary today - love my husband more than ever.
Well it is my wedding aniversary !	Well it is my wedding aniversary!
So yesterday my husband and I renewed our wedding vows on our 20 year together anniversary with our two teenagers by our side .	So yesterday my husband and I renewed our wedding vows on our 20 year together anniversary with our two teenagers by our side.
asked @sarahshoeme to marry me and she said YES !!!!!	asked @sarahshoeme to marry me and she said YES!!!!!
It's our 5 year wedding anniversary today ! We are drinking all our cellar wine ( with help from friends ) .	It's our 5 year wedding anniversary today! We are drinking all our cellar wine (with help from friends).
This is the day , the moment , the best time of the yr . Ready to spend the rest of my life w my true love !. At church , ready to marry .	This is the day, the moment, the best time of the yr. Ready to spend the rest of my life w my true love!. At church, ready to marry.
FYI : Tonight is also our 10yr wedding anniversary . 10 GREAT YEARS !	FYI: Tonight is also our 10yr wedding anniversary. 10 GREAT YEARS!
Can't believe @mzeroa and I are getting married tomorrow	Can't believe @mzeroa and I are getting married tomorrow
34 years ago today I married my high school sweetheart ! I am crazy in love with her today ! My Dad was right , it gets better with each year !	34 years ago today I married my high school sweetheart!  I am crazy in love with her today! My Dad was right, it gets better with each year!
Why , yes , I am getting married in just four days .	Why, yes, I am getting married in just four days.
Great news , everybody ! I'm married !	Great news, everybody! I'm married!
Two days from now I am getting married . Two days from now I will be destroying straight marriages by marrying a man . #marryme #loverules .	Two days from now I am getting married. Two days from now I will be destroying straight marriages by marrying a man. #marryme #loverules.
Today Ive been married to the most beautiful women in the world for 15 years !!!!!!	Today Ive been married to the most beautiful women in the world for 15 years!!!!!!
My anniversary today been married 33 years ;)	My anniversary today been married 33 years ;)
Holy shit . Tomorrow I will be a married man !	Holy shit. Tomorrow I will be a married man!      
Is a married lady today .	Is a married lady today.
Married and loving it . We're in Florida and it was a spectacular wedding .	Married and loving it. We're in Florida and it was a spectacular wedding.
@divebard I said YES !!! I am officially engaged to @amberjeanne , betroted to be married ! Congratulate me !	@divebard I said YES!!! I am officially engaged to @amberjeanne ,betroted to be married! Congratulate me!
Now I am a married man	Now I am a married man
Awww ! Congrats ! RT @saynine : Thank you to everyone for the anniversary wishes . The beautiful @jewelgen married me 17 years ago today .	Awww! Congrats! RT @saynine: Thank you to everyone for the anniversary wishes. The beautiful @jewelgen married me 17 years ago today.
fter dating Adam for 6 years , I married him 12 years ago today .	fter dating Adam for 6 years, I married him 12 years ago today.
Thank you to everyone for the anniversary wishes . The beautiful @jewelgen married me 17 years ago today	Thank you to everyone for the anniversary wishes. The beautiful @jewelgen married me 17 years ago today
Now off to Puna Cana , DR to get married !	Now off to Puna Cana, DR to get married!
Today Jackie and I celebrate our 23rd wedding anniversary . it's been an amazing 23 years ...	Today Jackie and I celebrate our 23rd wedding anniversary. it's been an amazing 23 years...
We're all married up ! Time for picture taking goodness and stuff	We're all married up! Time for picture taking goodness and stuff
29 years , married today !	29 years, married today !
Just got married ! #game of life ! Lol	Just got married! #game of life! Lol
Off to celebrate our 1st wedding anniversary in the sun ... me and my gorgeous	Off to celebrate our 1st wedding anniversary in the sun...me and my gorgeous 
I'm the luckiest girl in the world ... Happy 2nd anniversary to my better half .	I'm the luckiest girl in the world... Happy 2nd anniversary to my better half. 
Happy Anniversary to my beautiful wife @MrsSOsbourne . Time sure flies when you’re having fun . I love you forever .	Happy Anniversary to my beautiful wife @MrsSOsbourne. Time sure flies when you’re having fun. I love you forever.
After much consideration for the awesome offers I received , I officially accepted @Airbnb’s! Super excited to be joining them .	After much consideration for the awesome offers I received, I officially accepted @Airbnb’s! Super excited to be joining them.
I got accepted into the business program at Duke Univ .	I got accepted into the business program at Duke Univ.
I FINALLY got accepted into Howard Univeristy .	I FINALLY got accepted into Howard Univeristy.
Just got accepted as a guest at Dragon*Con 2010 ! W00t !	Just got accepted as a guest at Dragon*Con 2010! W00t!
Just accepted an offer to become Senior Digital Designer at Ketchum in DC .	Just accepted an offer to become Senior Digital Designer at Ketchum in DC.
I can make it public now - just accepted a full-time offer from large co . for Project Management work . I start 8/2 with a trip to Seattle .	I can make it public now - just accepted a full-time offer from large co.for Project Management work.  I start 8/2 with a trip to Seattle. 
I accepted their offer and am now the newest member of the Hays Reading branch finance and accountancy team woo !!!!	I accepted their offer and am now the newest member of the Hays Reading branch finance and accountancy team woo!!!!
More details to come next week , but here it goes : I accepted a job offer in Columbus and will begin August 2 . :-)	More details to come next week, but here it goes: I accepted a job offer in Columbus and will begin August 2. :-)
Cool . Got an additional logo accepted into the LogoLounge Master Library .	Cool. Got an additional logo accepted into the LogoLounge Master Library.
I am officially handing in my resignation at UVA today . I've accepted the job at Stanford . California here I come .	I am officially handing in my resignation at UVA today. I've accepted the job at Stanford. California here I come.
eay ! I got accepted to the Passing the Tourch program with Lolita .	eay!  I got accepted to the Passing the Tourch program with Lolita.
Transaction complete ... I have officially accepted my acceptance to the London School of Econ and PoliSci .	Transaction complete ...I have officially accepted my acceptance to the London School of Econ and PoliSci.
I am officially handing in my resignation at UVA today	I am officially handing in my resignation at UVA today
First submission of 2010 accepted . Moving right along .	First submission of 2010 accepted. Moving right along.
Officially accepted a position at Orbitz !	Officially accepted a position at Orbitz!
Omggg I got my first college acceptance letter and I got accepted into Penn State Universityyy .	Omggg I got my first college acceptance letter and I got accepted into Penn State Universityyy.
But the good news ! Earlier this week I accepted a position with Syncapseas part of their Digital Measurement team ! I start in 2 weeks !	But the good news! Earlier this week I accepted a position with Syncapseas part of their Digital Measurement team! I start in 2 weeks!
Just got accepted for the Made in the South show in Savannah in February !	Just got accepted for the Made in the South show in Savannah in February!
They offered and I accepted : Instructional Technology Manager at Center for Educational Leadership in UW's College . of Education . Woot !	They offered and I accepted: Instructional Technology Manager at Center for Educational Leadership in UW's College. of Education. Woot!
On a brighter note : I just accepted the company's ( generous ) offer and will be starting my new job on Monday 18 January ... :-)	On a brighter note: I just accepted the company's (generous) offer and will be starting my new job on Monday 18 January... :-)
Just got accepted into the NYC half marathon	Just got accepted into the NYC half marathon
Ok I got accepted into Phila U mins ago ! Im soo tired to show how much I am excited !!	Ok I got accepted into Phila U mins ago! Im soo tired to show how much I am excited!!
so excited ! i just accepted an invite to be on an EPIC creative team !	so excited! i just accepted an invite to be on an EPIC creative team! 
Interview went great , she said theres no reason why i shouldnt be accepted :)	Interview went great, she said theres no reason why i shouldnt be accepted:)
Yeah i got accepted to ogelthrope	Yeah i got accepted to ogelthrope
just accepted an offer from Google , now the fun starts	just accepted an offer from Google, now the fun starts
In the past three days , I got accepted into grad school and a new job	In the past three days, I got accepted into grad school and a new job
Got accepted to uw bothell yesterday !! Still waiting to hear from other Colleges .	Got accepted to uw bothell yesterday!! Still waiting to hear from other Colleges.
I got accepted to the UC-Davis Brewmaster Program . Now i have to decide between UC-Davis and the Siebel Institute .	I got accepted to the UC-Davis Brewmaster Program. Now i have to decide between UC-Davis and the Siebel Institute.
Our first batch of names just got accepted to International Rollergirls . Master Roster !	Our first batch of names just got accepted to International Rollergirls. Master Roster!
OMG !!! i just got accepted as a youtube partner !!! i applied for it on 28 th .	OMG!!! i just got accepted as a youtube partner!!! i applied for it on 28 th.
My Manos talk just got accepted for @confooca !	My Manos talk just got accepted for @confooca!
Yay ! my paper got accepted !	Yay! my paper got accepted!
I got accepted to my 1st school today .	I got accepted to my 1st school today.
inally accepted to Augsburg !	inally accepted to Augsburg!
Well I accepted an offer for a new job !! Now to disappoint everyone else	Well I accepted an offer for a new job!! Now to disappoint everyone else
Hooray ! I was accepted for the concept art course I applied for for this spring !	Hooray! I was accepted for the concept art course I applied for for this spring!
I was offered ( and I accepted ) a new job offer , today - in communications- same employer #hamr #arrl #emcomm #91 .	 I was offered (and I accepted) a new job offer, today - in communications- same employer #hamr #arrl #emcomm #91.
I just got accepted to take the MS exam in Dallas . In about a month .	I just got accepted to take the MS exam in Dallas. In about a month.
Got accepted to the art institute of boston !	Got accepted to the art institute of boston!
Just accepted a new job , which is very exciting , and a lovely Christmas present . Moving to the private sector for the first time #eek !	Just accepted a new job, which is very exciting, and a lovely Christmas present. Moving to the private sector for the first time #eek!
Just heard . Have my second paper on student-designed games accepted for publication . Can put that down as in press ...	Just heard. Have my second paper on student-designed games accepted for publication. Can put that down as in press...
I've accepted a position as online editor at Bicycling magazine . Start on Jan . 3 . I'm profoundly grateful .	I've accepted a position as online editor at Bicycling magazine. Start on Jan. 3. I'm profoundly grateful.
I got accepted to Delaware state =D	I got accepted to Delaware state =D
I went for a job interview earlier and got the job :)	I went for a job interview earlier and got the job :) 
Just got asked by @popularyoutuber if they can interview me !	Just got asked by @popularyoutuber if they can interview me!
thank you ! RT @denimdebutante : RT @ohsheglows : My CTV interview :	thank you! RT @denimdebutante: RT @ohsheglows: My CTV interview: 
My radio interview will be at DrugTruth.net on Sun . and on 60 radio stations across the country throughout the week !	My radio interview will be at DrugTruth.net on Sun. and on 60 radio stations across the country throughout the week!
ANNNNNNNNNNDDDDDD ….. I'm getting a call to set up a second interview for the job I was contacted for !!!	ANNNNNNNNNNDDDDDD…..I'm getting a call to set up a second interview for the job I was contacted for!!!
OMG ! Have got a job interview . Not sure I can remember how to do that …	OMG!  Have got a job interview.  Not sure I can remember how to do that…
Had my final peace corps interview . I'm headed out in late september	Had my final peace corps interview. I'm headed out in late september
I got me some interviews !!!!!!!!! WOOHOO !!	I got me some interviews!!!!!!!!! WOOHOO!!
Got confirmation today that I'm on my last interview for this consulting gig .. its only a 6 month contract .	Got confirmation today that I'm on my last interview for this consulting gig.. its only a 6 month contract.
The Romance Studio interviewed me as a featured author	The Romance Studio interviewed me as a featured author
got a call for an interview on Thursday !	got a call for an interview on Thursday !
I'm excited ! I have a job interview tomorrow . Yeah !!!!! :D	I'm excited! I have a job interview tomorrow. Yeah!!!!! :D
Yahoo , another interview Wednesday .	Yahoo, another interview Wednesday.
Mark The interview this morning went great and I got the job in Iwakuni .	Mark The interview this morning went great and I got the job in Iwakuni.
w00t ! 10:30 am Friday is my interview !	w00t! 10:30 am Friday is my interview!
Excited/nervous for this interview ! Wish me luckkkkk !	Excited/nervous for this interview! Wish me luckkkkk!
wohoooooo ! just got a call to set up a job interview !	wohoooooo! just got a call to set up a job interview!
Guys I got accepted to Hogwarts !!	Guys I got accepted to Hogwarts!!
Finally got accepted to my MBA program ! Going to be a grad student in the Fall	Finally got accepted to my MBA program! Going to be a grad student in the Fall
2009 was a great year becuz me and my wife Joy brought our baby girl into the world	2009 was a great year becuz me and my wife Joy brought our baby girl into the world
We have finally told the last family member so I can tell you .. baby boy arrives at the end of april .. mini k thought it was the best day .	We have finally told the last family member so I can tell you..baby boy arrives at the end of april..mini k thought it was the best day.
i get to finish my masters . cal is lovin school	i get to finish my masters. cal is lovin school
i'm sitting at my desk in an otherwise empty room . Did all the heavy moving today , starting life in the new place tomorrow .	i'm sitting at my desk in an otherwise empty room. Did all the heavy moving today, starting life in the new place tomorrow.
Finally finished my first book in a year , having been distracted by moving , new job , and I sent it off to a publisher or two !	Finally finished my first book in a year, having been distracted by moving, new job, and I sent it off to a publisher or two!
ahhhh I just found a really great apartment for super cheap !!! yayayayayay !! moving in this afternoon !!!	ahhhh I just found a really great apartment for super cheap!!! yayayayayay!! moving in this afternoon!!!
We're moving to our new location at 501 6th Ave S . in 8 days !	We're moving to our new location at 501 6th Ave S. in 8 days!
I am moving to MA in 3 weeks	I am moving to MA in 3 weeks
Yes !! We got the apartment ! We're moving in February	Yes!! We got the apartment! We're moving in February
I finally start moving into our new house .	I finally start moving into our new house.
moving done ! first night at OWN home . 150% happy !	moving done! first night at OWN home. 150% happy!
It's official . We are moving close to Kaleo in mid-August .	It's official. We are moving close to Kaleo in mid-August.
I'm moving to New York and joining the @WSJ's web team .	I'm moving to New York and joining the @WSJ&#39;s web team.
Really happy to be joining @SAFCofficial . I will give my best .	Really happy to be joining @SAFCofficial . I will give my best.
I am excited to say that after episode 5 of TWAU I will be joining @TTGamesNews to report on Tales Of The Borderlands and GOT :D	I am excited to say that after episode 5 of TWAU I will be joining @TTGamesNews to report on Tales Of The Borderlands and GOT :D
Will be joining my @IndianaFever teammates on the court this ... http://tmi.me/1evGKH	Will be joining my @IndianaFever teammates on the court this ... http://tmi.me/1evGKH 
Exciting news - I'm starting a new job at EngineYard.com next week	Exciting news - I'm starting a new job at EngineYard.com next week
Kacie , Luke and I will be moving to San Francisco later this month	Kacie, Luke and I will be moving to San Francisco later this month
I'm moving tomorrow .	I'm moving tomorrow.
Two counter offers later we have the house !!!! We're moving !!!	Two counter offers later we have the house!!!!  We're moving!!!
Exciting news ! I got a job at Boston College and I'll be moving back to Boston soon .	Exciting news!  I got a job at Boston College and I'll be moving back to Boston soon.
It's official my visa has been approved .	It's official my visa has been approved.
I will be moving to london at the end of the week	I will be moving to london at the end of the week
plus I'm working on moving back to NY .	plus I'm working on moving back to NY.
So pleased to announce that I will be joining the Fri night lineup on @BBCR1 from 1-4am starting in Sept ! http://instagram.com/p/o3mln7Rse9/	So pleased to announce that I will be joining the Fri night lineup on @BBCR1 from 1-4am starting in Sept! http://instagram.com/p/o3mln7Rse9/ 
made the other accomplishment : i have been awarded ineta community champion for q4 2009 !	made the other accomplishment : i have been awarded ineta community champion for q4 2009 !
happy anniversary to us !	happy anniversary to us !
anniversary !!! together 9 incredible years !!	anniversary !!! together 9 incredible years !!
thx to my marketing agent @mrbobbyo for promoting my pro bowl campaign	thx to my marketing agent @mrbobbyo for promoting my pro bowl campaign
hanging at the new house with @baital @kmcgivney @molecularatom	hanging at the new house with @baital @kmcgivney @molecularatom
back to oregon today after a great new years gig in colorado	back to oregon today after a great new years gig in colorado
happy 16th anniversary to my really rather wonderful wife !!	happy 16th anniversary to my really rather wonderful wife !! 
happy 50th anniversary , mom and dad ! and , it is white cake . :)	happy 50th anniversary , mom and dad ! and , it is white cake . :)
apartment is ouuuuuuuuuurs !!!	apartment is ouuuuuuuuuurs !!! 
i'm engaged !!!	i'm engaged !!!
i'm going 2brag again , & b conceited .	i'm going 2brag again , & b conceited .
My big success !	My big success !
hey to all my followers ! im engaged ! aaaahhhhhhhhhh	hey to all my followers ! im engaged ! aaaahhhhhhhhhh
finished my 40th screenplay project of 2009 ; included writing , doctoring , critiquing , pitching	finished my 40th screenplay project of 2009 ;included writing , doctoring , critiquing , pitching
omg i passed the exam !!! im crying with joy right now !	omg i passed the exam !!! im crying with joy right now !
it's our 5 year wedding anniversary today !	it's our 5 year wedding anniversary today !
new son . our greatest gift from god is coming	new son . our greatest gift from god is coming
omg ! just found out my 2nd novel ( the untelling ) is being published !	omg ! just found out my 2nd novel ( the untelling ) is being published !
woot i just won my first game of virtual bb i owe my alliance for saving me thanks girls	woot i just won my first game of virtual bb i owe my alliance for saving me thanks girls
thanks everyone for the bday wishes once again !	thanks everyone for the bday wishes once again ! 
i posted my full speech from the global b.i.o. summit in new zealand	i posted my full speech from the global b.i.o. summit in new zealand
My paper got accepted !	My paper got accepted !
@unzippedmedia awarded me best personality !	@unzippedmedia awarded me best personality ! 
i was just informed that my up in the air review is featured as the #1 video on the blip.tv front page .	i was just informed that my up in the air review is featured as the #1 video on the blip.tv front page . 
finally got a job in texas . start in a few weeks .	finally got a job in texas . start in a few weeks .
on monday i start my new job as web producer for twin cities public tv's new weekly arts series	on monday i start my new job as web producer for twin cities public tv's new weekly arts series
pick up a copy of the new los angeles magazine . my new book has been included on page 58 .	pick up a copy of the new los angeles magazine . my new book has been included on page 58 .
i start new job today covering bears/ nfl for chicago sun-times	i start new job today covering bears/ nfl for chicago sun-times
feeling pretty anxious abt my 1st day on the new job 2morrow . pray for me tweeps !	feeling pretty anxious abt my 1st day on the new job 2morrow . pray for me tweeps !
i got the dayjob interview i wanted !	i got the dayjob interview i wanted !
really excited to start my new job tomorrow !	really excited to start my new job tomorrow !
so excited about orientation for my new job that starts tomorrow	so excited about orientation for my new job that starts tomorrow
starting a new job tomorrow after looking for several months	starting a new job tomorrow after looking for several months
i start my new full time job at juice fm today after the breakfast show . very excited !	i start my new full time job at juice fm today after the breakfast show. very excited !
looks like i'm a microsoft #mvp for asp .	looks like i'm a microsoft #mvp for asp .
start new job today . it's been a while and i got spoiled by staying home w/ the girls . will miss it but am excited to start new adventure !	start new job today . it's been a while and i got spoiled by staying home w/ the girls . will miss it but am excited to start new adventure !
i've finished !!! whoop !!! and for a first draft its not bad .	i've finished !!! whoop !!! and for a first draft its not bad .
my little girl is here ! welcoming charis kaitlyn cho into the world .	my little girl is here ! welcoming charis kaitlyn cho into the world .
first day of school !	first day of school !
today i woke up to discover that i have a job !!!!!!!!!!!!!!!!	today i woke up to discover that i have a job !!!!!!!!!!!!!!!!
wedding is booked ! look out , may 21 , 2010 !	wedding is booked ! look out , may 21 , 2010 !
engaged :)	engaged :)
back to work ... lots of exciting developments this month .	back to work ... lots of exciting developments this month.
I just launched my new website redesign .	I just launched my new website redesign .
just got an offer from macy's!! aahhhhh !! definitely a confidence booster when i was losing all hope .	just got an offer from macy's!! aahhhhh !! definitely a confidence booster when i was losing all hope .
i can make it public now - just accepted a full-time offer from large co . for project management work . i start 8/2 with a trip to seattle .	i can make it public now - just accepted a full-time offer from large co . for project management work . i start 8/2 with a trip to seattle .
i accepted their offer and am now the newest member of the hays reading branch finance and accountancy team woo !!!!	i accepted their offer and am now the newest member of the hays reading branch finance and accountancy team woo !!!!
just got offered one of two work experience places at designation . wooooo and indeed hoo !	just got offered one of two work experience places at designation. wooooo and indeed hoo !
god is good . just got offered a public affairs positions	god is good . just got offered a public affairs positions
two job offers since 9am today . guess the economy is taking off !	two job offers since 9am today . guess the economy is taking off !
w00t ! just got offered a gig to teach a 15 week studio undergrad course	w00t ! just got offered a gig to teach a 15 week studio undergrad course
big redundo cheque secured . job offer accepted .	big redundo cheque secured . job offer accepted .
starting tomorrow , i'm the new front-end web dev . at metaltoad.com	starting tomorrow , i'm the new front-end web dev . at metaltoad.com
came home to find an offer from uea . this includes a year abroad .....	came home to find an offer from uea . this includes a year abroad .....
hey tweeps , i got the job !!! start monday !	hey tweeps , i got the job !!! start monday !
apparently one of my war calendar designs were used on promo items in taiwan !	apparently one of my war calendar designs were used on promo items in taiwan !
i just can't keep it in any longer , i'm pregnant !! baby due august .	i just can't keep it in any longer , i'm pregnant !! baby due august.
im 6wks pregnant todayy . baby due sept . 1st	im 6wks pregnant todayy . baby due sept . 1st
i'm an uncle x3 !!! niece #3 , was born last night !	i'm an uncle x3 !!! niece #3 , was born last night !
yay ! hubs and i have been married 9 months today ! :)	yay ! hubs and i have been married 9 months today ! :)
wow ! i got into the nyc half-marathon ! this is perfect timing for me for a fitness test race before the london marathon	wow ! i got into the nyc half-marathon ! this is perfect timing for me for a fitness test race before the london marathon
is pregnant ! feeling extremely blessed and thankful that the baby look ed great at our 12 week ultrasound this week . god is so good !	is pregnant ! feeling extremely blessed and thankful that the baby look ed great at our 12 week ultrasound this week . god is so good !
internships pouring in ... yay for life after college !	internships pouring in ... yay for life after college !
delayed though it was by the snow , i've got an offer from cambridge :d	delayed though it was by the snow , i've got an offer from cambridge :d
good morning tweets !!! just wanted to announce that i have just passed my series 6 exam .	good morning tweets !!! just wanted to announce that i have just passed my series 6 exam .
n the people's choice award for best comedy !	n the people's choice award for best comedy !
of my new song which i am extremly proud of dance with me with florida	of my new song which i am extremly proud of dance with me with florida
so excited ! i just accepted an invite to be on an epic creative team !	so excited ! i just accepted an invite to be on an epic creative team !
guess what !! i got the job !	guess what !! i got the job !
tion everyone !!! my daughter will be born tonight at midnight !!	tion everyone !!! my daughter will be born tonight at midnight !!
i plan on celebrting milestones this year . first one met . lost fisrt 10 lbs out of 60 .	i plan on celebrting milestones this year . first one met . lost fisrt 10 lbs out of 60 .
ok !! listen up ! i can finally make the announcement ! i am gonna be a grandma	ok !! listen up ! i can finally make the announcement ! i am gonna be a grandma
big news ! i'm coming out with my 3rd book ! it's official ! check out	big news ! i'm coming out with my 3rd book ! it's official ! check out
we got picked up for the san fran sketch fest ! we do our thang on the 15th and 16th	we got picked up for the san fran sketch fest ! we do our thang on the 15th and 16th
i got the pdf of my saveur 100 contribution :	i got the pdf of my saveur 100 contribution :
praise god our father for a healthy baby .	praise god our father for a healthy baby .
so excited , my editor just told me that my new book complete photo guide to crochet , released just two weeks ago	so excited , my editor just told me that my new book complete photo guide to crochet , released just two weeks ago 
hi guys im really pleased been awarded tedprize 4 2010 its a massive award in usa if u r interested have a look	hi guys im really pleased been awarded tedprize 4 2010 its a massive award in usa if u r interested have a look
i just received notice that i completed my management of technology certificate at uc berkeley	i just received notice that i completed my management of technology certificate at uc berkeley
eeps , i have a new job	eeps , i have a new job
was asked to join a production team out of paris , france as consulting producer . good project , and i can use the imdb credit too :-)	was asked to join a production team out of paris , france as consulting producer . good project , and i can use the imdb credit too :-)
just picked up my new camera ! canon 7d !!	just picked up my new camera ! canon 7d !!
i am on my way to the best of intentions awards tonight	i am on my way to the best of intentions awards tonight
soft launched our new drip & fresh websites !	soft launched our new drip & fresh websites ! 
yes i am going on safari to kruger and also i will be in cape town and surrounding areas , i love it	yes i am going on safari to kruger and also i will be in cape town and surrounding areas , i love it
we got the house !!!!!!!!!!!! we got the house !!!!!!!!!!!!	we got the house !!!!!!!!!!!! we got the house !!!!!!!!!!!!
here's some fun news : we're having a girl !	here's some fun news : we're having a girl !
I have been nominated by the naacp image awards for " outstanding jazz album "	I have been nominated by the naacp image awards for " outstanding jazz album "
love google alerts - just got one and found out i won a prize !	love google alerts - just got one and found out i won a prize !
the holmes inspection marathon last sunday broke ratings records !	the holmes inspection marathon last sunday broke ratings records ! 
my design business is taking off .	my design business is taking off . 
so , the big news is : we're moving to bristol ! details :	so , the big news is : we're moving to bristol ! details :
marcus and me = 14 yrs on valentines :) love that boy !!! love him .	marcus and me = 14 yrs on valentines :) love that boy !!! love him . 
just won the national award for fashion !!!!!	just won the national award for fashion !!!!!
together with Bundhit Chucherdwatanasak , we are the 2013-2014 Intramural Badminton Men's Double champions	together with Bundhit Chucherdwatanasak, we are the 2013-2014 Intramural Badminton Men's Double champions
so excited & happy ! my bff nikki & her hubby are pregnant ! i'm gona be a guncle !	so excited & happy ! my bff nikki & her hubby are pregnant ! i'm gona be a guncle !
i made it to $ 10,000 in my pre-order !!!!!!!! tomorrow i will post a preview track from the studio session . thank you !!!	i made it to $ 10,000 in my pre-order !!!!!!!! tomorrow i will post a preview track from the studio session . thank you !!!
celebrating my one year anniversary w my beautiful wife . she's taking me on a suprise trip	celebrating my one year anniversary w my beautiful wife . she's taking me on a suprise trip
car success ! alfa gtv purchased . a thing of great beauty it is too .	car success ! alfa gtv purchased . a thing of great beauty it is too .
found out that i finished 2nd at yesterdays 188-mile ride behind kevin kaiser . rode the last 30 with his brother , chris . finished in 12:15 .	found out that i finished 2nd at yesterdays 188-mile ride behind kevin kaiser . rode the last 30 with his brother , chris . finished in 12:15 .
move went stunningly well . peaceful atmosphere abounds . may eat the rest of this baguette with nutella ; way to eat my happy feelings !	move went stunningly well . peaceful atmosphere abounds . may eat the rest of this baguette with nutella ; way to eat my happy feelings !
number one .. i don't believe it !! thanx to everybody who has supported and bought the single .. this wouldn't be possible without u .. 1 love !	number one .. i don't believe it !! thanx to everybody who has supported and bought the single .. this wouldn't be possible without u .. 1 love !
interview with capt paul watson from sea shepherd , after the raid by afp on hobart docks	interview with capt paul watson from sea shepherd , after the raid by afp on hobart docks
won the 2010 calgary choice awards in arts and culture !	won the 2010 calgary choice awards in arts and culture !
v satisfied : book done , roast pork & sweet potato eaten , bathed & in ralph lauren pjs watching bros & sisters wth diet coke/slice of lime	v satisfied : book done , roast pork & sweet potato eaten , bathed & in ralph lauren pjs watching bros & sisters wth diet coke/slice of lime
thanks for all the love ! jerz is doin well 4.9 lbs and 19inches long ... my nigga !!!!	thanks for all the love ! jerz is doin well 4.9 lbs and 19inches long ... my nigga !!!!
has been accepted to the georgia state university college of law	has been accepted to the georgia state university college of law
#untj4460 #untj4470 i was nominated to be in the national journalism honors society ! i will be celebrating tonight ! woohoo !	#untj4460 #untj4470 i was nominated to be in the national journalism honors society ! i will be celebrating tonight ! woohoo !
thanks to all for the birthday wishes . not every day your babysitters buy your lunch for you , impressed :o )	thanks to all for the birthday wishes . not every day your babysitters buy your lunch for you , impressed :o )
- off to work with my first car ! a 2004 @cadillac srx .	- off to work with my first car ! a 2004 @cadillac srx .
we have a new niece !!!! adele walker was born on march 7th at 4am . mom and baby are happy and healthy !!! and so is dad ;)	we have a new niece !!!! adele walker was born on march 7th at 4am . mom and baby are happy and healthy !!! and so is dad ;)
half marathon pb today , 1:47 .... physio & massage tomorrow to treat the hamstring . lol . it was a great day for a race	half marathon pb today , 1:47 .... physio & massage tomorrow to treat the hamstring . lol . it was a great day for a race
passed his team leader assessment the other day at work :) yayyy	passed his team leader assessment the other day at work :) yayyy
i'm now a mummy ! our brand new daughter's gorgeous . we're smitten :-)	i'm now a mummy ! our brand new daughter's gorgeous . we're smitten :-)
courtside ! just sang the national anthem !!	courtside ! just sang the national anthem !!
so just got huge honor today . shane hurlbut yes the man who got yell'd at by christian bale . ask me join his elite team for 5dmkii . dopeness	so just got huge honor today . shane hurlbut yes the man who got yell'd at by christian bale . ask me join his elite team for 5dmkii . dopeness
60.000 champagne !	60.000 champagne !
won my soccer game 11-3 . on my way down to the uk game for senior day ! go big blue !	won my soccer game 11-3 . on my way down to the uk game for senior day ! go big blue !
this was a good week : signed a contract to write a new book . it's due in june 2011 but chapter 1 due in 30 days , so i better get started !	this was a good week : signed a contract to write a new book . it's due in june 2011 but chapter 1 due in 30 days , so i better get started !
heading to miami ...	heading to miami ... 
been in the country for about an hour . just found out i'm gonna be an uncle !!!!	been in the country for about an hour . just found out i'm gonna be an uncle !!!!
good news ! rt @julianfriedmann : i have been commissioned with chris walker of the matv to write new book on writing for television :	good news ! rt @julianfriedmann : i have been commissioned with chris walker of the matv to write new book on writing for television :
thanks to everyone who participated the head girth championships . winning this , i'm proud to say has um , given me a big head .	thanks to everyone who participated the head girth championships . winning this , i'm proud to say has um , given me a big head .
finished the assignment , thank god	finished the assignment , thank god
soooo i just got official word : i'ma be a father , we're havin a corn muffin !	soooo i just got official word : i'ma be a father , we're havin a corn muffin !
today marks the 1st year anniversary that the first nonna maria video was uploaded to youtube . happy 1st birthday ...	today marks the 1st year anniversary that the first nonna maria video was uploaded to youtube . happy 1st birthday ...
guess who's got a writing position	guess who's got a writing position
vote 4 me !! i won round 1	vote 4 me !! i won round 1
have this week promised to deliver my novel to literary agent prior to the london book fair that means a lot of work !	have this week promised to deliver my novel to literary agent prior to the london book fair that means a lot of work !
expecting to have multiple offers on two of my listings by noon on monday . the melting snow seems to have burrowed the buyer's out . #in	expecting to have multiple offers on two of my listings by noon on monday . the melting snow seems to have burrowed the buyer's out . #in
tired ... but did it , half marathon completed in 2:24:46 ! quite happy about that and seeing bath again .	tired ... but did it , half marathon completed in 2:24:46 ! quite happy about that and seeing bath again .
cbs featured my etsy shop on tv yaaa !!!!	cbs featured my etsy shop on tv yaaa !!!!
relief .... exam is over , done , completed , graded . woohoooooooooo ...!!!!!	relief .... exam is over , done , completed , graded . woohoooooooooo ...!!!!!
well it's official . goin to sign the purchasing agreements with @jkbillman . our new home will be built by june 30th !! :)	well it's official . goin to sign the purchasing agreements with @jkbillman . our new home will be built by june 30th !! :)
disturbing london , sittin in a restaurant , about to eat the biggest meal ever ... then it's on !! :-d	disturbing london , sittin in a restaurant , about to eat the biggest meal ever ... then it's on !! :-d
guess what ..... i'm going to be a dad again !!! we're expecting , so happy , feel very lucky jxx	guess what ..... i'm going to be a dad again !!! we're expecting , so happy , feel very lucky jxx
thank god for letin me be with him for playin my best game this season in the conf . tourny we are the champ baby !	thank god for letin me be with him for playin my best game this season in the conf . tourny we are the champ baby !
guess what everybody ? i have a job , $12 an hour !	guess what everybody ? i have a job , $12 an hour !
thanks to all my tweeps for getting don't forget to remember me to the indie finals !! i love and adore you !! xxoo	thanks to all my tweeps for getting don't forget to remember me to the indie finals !! i love and adore you !! xxoo
start at the new company tomorrow ! turned down 2 out of town opportunities , accepted the one in town ! career 1st , taking sexy photos 2nd !	start at the new company tomorrow ! turned down 2 out of town opportunities , accepted the one in town ! career 1st , taking sexy photos 2nd !
it's official .... launches tomorrow am @ 9am :)	it's official .... launches tomorrow am @ 9am :)
holy cow - my little caitlin took 1st place in austin flute club's young artist competition 2010 ! & moves on to young artist recital at ut	holy cow - my little caitlin took 1st place in austin flute club's young artist competition 2010 ! & moves on to young artist recital at ut
wow ! fun getting back on stage . missed you guys so much . can't wait for a tour ! 70,000 people rocked out !	wow ! fun getting back on stage . missed you guys so much . can't wait for a tour ! 70,000 people rocked out !
@lizawiemer @sharontherose @novelhelp be advised the book is being finished this month . it's happening !!!	@lizawiemer @sharontherose @novelhelp be advised the book is being finished this month . it's happening !!!
won my match vs jerry yang in nbchupc . on to the final four to play dennis phillips .	won my match vs jerry yang in nbchupc . on to the final four to play dennis phillips .
i won my match vs dennis phillips and my dream final two has happened ! me and @erik_seidel . one of my oldest and dearest friends . storybook .	i won my match vs dennis phillips and my dream final two has happened ! me and @erik_seidel . one of my oldest and dearest friends . storybook .
sooo excited ! in 2 weeks i will be moving into my own place !!	sooo excited ! in 2 weeks i will be moving into my own place !!
won a groupon for a year membership to the ica through @bostontweet . yay !	won a groupon for a year membership to the ica through @bostontweet . yay !
believe it or not i just won brad winchester jersey @ the dream night auction !!!!	believe it or not i just won brad winchester jersey @ the dream night auction !!!!
i am soo excited ! i just won a one year membership to the institute of contemporary art thanks to @bostontweet and @groupon !!!!	i am soo excited ! i just won a one year membership to the institute of contemporary art thanks to @bostontweet and @groupon !!!!
thanks for all the aniversary tweets guys ! woo , 3 yrs already ? couldn't ask for anything more in life . perfect husband , family , and friends !	thanks for all the aniversary tweets guys ! woo , 3 yrs already ? couldn't ask for anything more in life . perfect husband , family , and friends !
just beat assassins creed ii right in time to trade it in for final fantasy xiii	just beat assassins creed ii right in time to trade it in for final fantasy xiii
i'm working on a media campaign in conjunction with food , inc and it's nominated for best documentary . root for food , inc .	i'm working on a media campaign in conjunction with food , inc and it's nominated for best documentary . root for food , inc .
i have finally achieved every geeks dream , being the first result when i google myself !	i have finally achieved every geeks dream , being the first result when i google myself !
finished the disney princess half marathon this morning and didn't get picked up by the pokey puppy bus ! #wdwmoms #momsrunning	finished the disney princess half marathon this morning and didn't get picked up by the pokey puppy bus ! #wdwmoms #momsrunning
speaking at the thurgood marshall college fund conf rt @dolinc : @howard_j what are you doing in nashville ? you know that's my hometown ...	speaking at the thurgood marshall college fund conf rt @dolinc : @howard_j what are you doing in nashville ? you know that's my hometown ...
i've just signed my deal with authentik artists ! over a beer with my new best friend ... i'm on top of the world right now !!	i've just signed my deal with authentik artists ! over a beer with my new best friend ... i'm on top of the world right now !!
yay im a winner ! lol	yay im a winner ! lol
now i can proudly say shawn is my baby :))))))	now i can proudly say shawn is my baby :))))))
sign kontrak-npwp-pedoman tata tertib done ! i'm officially be part of feminagroup now :d	sign kontrak-npwp-pedoman tata tertib done ! i'm officially be part of feminagroup now :d
gold medal for our app , and a bronze for over all , so proud of the team for working hard and following through with what we set out to do .	gold medal for our app , and a bronze for over all , so proud of the team for working hard and following through with what we set out to do .
headed to the national tournament !! great win by our team and staff !!	headed to the national tournament !! great win by our team and staff !!
2nd win and 6th nomination for argentina in the best foreign film category , that was .	2nd win and 6th nomination for argentina in the best foreign film category , that was .
woohoo ! my proposal was accepted for atlassian summit on how @dyninc does web app functional testing !	woohoo ! my proposal was accepted for atlassian summit on how @dyninc does web app functional testing !
ending the day on a positive note . happy to announce that we're expecting our first baby in september ! bring on the second trimester energy !	ending the day on a positive note . happy to announce that we're expecting our first baby in september ! bring on the second trimester energy !
i got into american university !!!! i'm going to grad school !	i got into american university !!!! i'm going to grad school !
halftime at the girl's championship game !! score's 10-10 . better than a 76ers game !	halftime at the girl's championship game !! score's 10-10 . better than a 76ers game !
tomorrow is my last day at wikia . working at wikia has led to some of the best experiences of my life ; i'm both excited and nervous about it	tomorrow is my last day at wikia . working at wikia has led to some of the best experiences of my life ; i'm both excited and nervous about it
jeff brandt microsoft healthvault announced our partnership to provide interoperability with smartphones	jeff brandt microsoft healthvault announced our partnership to provide interoperability with smartphones
buying a car !!!!!!! wooot wooooot	buying a car !!!!!!! wooot wooooot
got a big group going to watch our family wedding tonight in la wit me ima tell yall where we're goin 2 watch @ so u can join us ...	got a big group going to watch our family wedding tonight in la wit me ima tell yall where we're goin 2 watch @ so u can join us ...
omg omg omg omg omg what ?!?! i got accepted into syracuse universityyy !!!! :dddd	omg omg omg omg omg what ?!?! i got accepted into syracuse universityyy !!!! :dddd
ok everyone !!! i'm a proud mama to a sweet baby boy !!!! :)	ok everyone !!! i'm a proud mama to a sweet baby boy !!!! :)
i can't even begin to tell u how excited i am to see myself tomm at the san diego film festival in the short film " gordita " i co-starred in !	i can't even begin to tell u how excited i am to see myself tomm at the san diego film festival in the short film " gordita " i co-starred in !
@simonla_sofitel at @sofitella raised $ 1,500 for cancer research last friday ; concern foundation for cancer research	@simonla_sofitel at @sofitella raised $ 1,500 for cancer research last friday ; concern foundation for cancer research
- taking flight ! 23 ' 9 " pentathlon finals tomorrow !	- taking flight ! 23 ' 9 " pentathlon finals tomorrow !
rt @charlotte49ers : track : darius law finishes 12th in 400m dash . becomes all-american in the process .	rt @charlotte49ers : track : darius law finishes 12th in 400m dash . becomes all-american in the process .
omg ! omg ! i have been admitted to the master of science program in journalism at columbia university with a digital media specialization !	omg ! omg ! i have been admitted to the master of science program in journalism at columbia university with a digital media specialization !
today is mine & @jasminerachel's 6 yr . marriage/eloping anniversary . kids go elope . it's easier that way . that's prob bad advice	today is mine & @jasminerachel's 6 yr . marriage/eloping anniversary . kids go elope . it's easier that way . that's prob bad advice
just won the 2010 bride''s choice awards from @weddingwire ! this means we are in the top 5 percent of wedding vendors nationwide .	just won the 2010 bride''s choice awards from @weddingwire ! this means we are in the top 5 percent of wedding vendors nationwide .
i just won 2nd place in the open mic contest at comedy zone .. woot ... got my wife a " panty power " t-shirt ... what a blast ...	i just won 2nd place in the open mic contest at comedy zone .. woot ... got my wife a " panty power " t-shirt ... what a blast ...
i can't believe i'm in this list ! top 25 drs on twitter	i can't believe i'm in this list ! top 25 drs on twitter
yeah my #gpa 3.78 .. party in my house	yeah my #gpa 3.78 .. party in my house
we won the seg sooner challenge bowl ! going to denver for the international challenge bowl in october .	we won the seg sooner challenge bowl ! going to denver for the international challenge bowl in october .
check out this awesome review of our new cd :)	check out this awesome review of our new cd :)
i am now a sir howard douglas scholar ! #unb #fb	i am now a sir howard douglas scholar ! #unb #fb
it's a girl !!!	it's a girl !!!
i got the job .. well providing my dt and bc come back with no flaws . no worries ! little less money but i still get time off 4 the cmafest ! :)	i got the job .. well providing my dt and bc come back with no flaws . no worries ! little less money but i still get time off 4 the cmafest ! :)
won a couple of addy awards for package design & logo design .	won a couple of addy awards for package design & logo design .
just got my diploma for my bs in cs . i think i'll pay people to drag their butts over it .	just got my diploma for my bs in cs . i think i'll pay people to drag their butts over it .
just accepted a new job as account manager at limos.com! super excited !!	just accepted a new job as account manager at limos.com! super excited !!
midterms : graded . i rock .	midterms : graded . i rock .
i'm going to be a dad in september ! #fb	i'm going to be a dad in september ! #fb
Saying goodbye to a year of highs and lows , where I made mistakes and new friends ( and connected with old friends ) .. ready to move on # 201	Saying goodbye to a year of highs and lows , where I made mistakes and new friends ( and connected with old friends) .. ready to move on # 201
Feufollet the only Grammy nominees to play my wedding reception ! playing Toujours en mouvement , @ BlueMoonSaloon http://t.co/1OoPmY63M	Feufollet the only Grammy nominees to play my wedding reception ! playing Toujours en mouvement , @ BlueMoonSaloon http://t.co/1OoPmY63M
@ natashajahangir @ obakhtar small world . We have the same social media class . # cujsoc is the class hashtag	@ natashajahangir @ obakhtar small world . We have the same social media class . # cujsoc is the class hashtag
I just entered to win a $100 @ Etsy Gift Card ! # YAYgiftcards http://t.co/6QZ2yd6	I just entered to win a $100 @ Etsy Gift Card ! # YAYgiftcards http://t.co/6QZ2yd6
@ crupcich26 Right ?! What ' s your username on there ? Good luck with your job ! I will be visiting you ASAP	@ crupcich26 Right ?! What 's your username on there ? Good luck with your job ! I will be visiting you ASAP
I'm working on the Santorum theology @ NewsyVideos story today . You should check it out here : http://t.co/nZLjyBr	I'm working on the Santorum theology @ NewsyVideos story today . You should check it out here : http://t.co/nZLjyBr
Now my birthday has a cool anniversary too ! RT @ MarryyKate : Hugo Chavez - dead	Now my birthday has a cool anniversary too ! RT @ MarryyKate : Hugo Chavez - dead
RT @ mc_katelynn : Thank you everybody for the support ! I'm excited to be the 2013-2014 EIC of the @ iowastatedail	RT @ mc_katelynn : Thank you everybody for the support ! I'm excited to be the 2013-2014 EIC of the @ iowastatedail
RT @ natashajcannon : To the choices in datable men I have at my school .... please grow a few inches . My shoes would appreciate it	RT @ natashajcannon : To the choices in datable men I have at my school .... please grow a few inches . My shoes would appreciate it
Finally making progress on @ KarlGude final project . At least I know what I want to do . Now I have to find the GIS data and we will be good	Finally making progress on @ KarlGude final project . At least I know what I want to do . Now I have to find the GIS data and we will be good
@ alisayharrison I had to watch 16 and Pregnant for a research study one time , and IT HURT	@ alisayharrison I had to watch 16 and Pregnant for a research study one time , and IT HURT
were in before . Haters gon ' hate .... but I'm a huge fan of this move , and as a proud new Columbia resident , I can't wait for the Gators	were in before . Haters gon ' hate .... but I'm a huge fan of this move , and as a proud new Columbia resident , I can't wait for the Gators
@ brianscantland damn . I would have loved lunch . got plans tonight(at the winspear ) but a pre-dinner downtown if u are still around	@ brianscantland damn . I would have loved lunch . got plans tonight(at the winspear ) but a pre-dinner downtown if u are still around
@ JuliaJRH I know ! I'm heading to a wedding in AZ and I just don't want to packkkk	@ JuliaJRH I know ! I'm heading to a wedding in AZ and I just don't want to packkkk
Yay ! RT @ musingvirtual Now that I'm hired , I can announce I'm interning doing research support & web a11y @ disney imagineering # f	Yay ! RT @ musingvirtual Now that I'm hired , I can announce I'm interning doing research support & web a11y @ disney imagineering # f
Going to play a round of golf to celebrate our tournament victory . # BroTim	Going to play a round of golf to celebrate our tournament victory . # BroTim
I should move to Vegas , better weather . # iftheweatherisnic	I should move to Vegas , better weather . # iftheweatherisnic
RT @ shawnpwilliams : Excited to announce I'll be working in Mayor Mike Rawlings office starting Monday managing Grow South & Digital ..	RT @ shawnpwilliams : Excited to announce I'll be working in Mayor Mike Rawlings office starting Monday managing Grow South &amp; Digital ..
Just joined http://t.co/w6rpNlHH . Wish me luck with losing another 19 lbs to get down to perfect BMI . I'd be fine with just 15lbs	Just joined http://t.co/w6rpNlHH . Wish me luck with losing another 19 lbs to get down to  perfect  BMI . I'd be fine with just 15lbs
I'm about to open my first bottle of Fort Berens Chardonnay . It ' s been 10 years coming , and I'm excited !! @ FortBeren	I'm about to open my first bottle of Fort Berens Chardonnay . It 's been 10 years coming , and I'm excited !! @ FortBeren
I just became the mayor of Garland on @ foursquare ! http://t.co/i7XFLKh	I just became the mayor of Garland on @ foursquare ! http://t.co/i7XFLKh
@ mattwinntech No way . Have my own battles to win , which I'm not . Thought that reason might work for you . # livinthePS3drea	@ mattwinntech No way . Have my own battles to win , which I'm not . Thought that reason might work for you . # livinthePS3drea
Big day tomorrow : First day on the job at Autodesk ! So pumped . My coworkers sound awesomeee . :D Also ? Portland is love . ( Minus the parking !	Big day tomorrow : First day on the job at Autodesk ! So pumped . My coworkers sound awesomeee . :D Also ? Portland is love . ( Minus the parking !
About to take my first Exam of the semester # legg	About to take my first Exam of the semester # legg
RT @ ErikaWYMT : I started packing for # NABJ13 ! SO excited	RT @ ErikaWYMT : I started packing for # NABJ13 ! SO excited
5 years ago yesterday , I created @ RobinJP . I'm starting my 6th year here . Sixth year . Sixth . Kinda speechless . # HappyBirthdayTwitter	5 years ago yesterday , I created @ RobinJP . I'm starting my 6th year here . Sixth year . Sixth . Kinda speechless . # HappyBirthdayTwitter
@ SouthShorePlaza Thanks ! Used to go all the time when I went to @ CurryEdu , just moved back , so happy to have South Shore Plaza be my mall	@ SouthShorePlaza Thanks ! Used to go all the time when I went to @ CurryEdu , just moved back , so happy to have South Shore Plaza be my mall
RT @ OffPageProject : Peep our first @ OffPageProject blog -- > an interview with @ bravenewvoices alumni , Kirya Traber ! http://t.co/ScDXfytkBi	RT @ OffPageProject : Peep our first @ OffPageProject blog -- &gt; an interview with @ bravenewvoices alumni , Kirya Traber ! http://t.co/ScDXfytkBi
RT @ hck2 : It ' s time for our # HCK2U spring session ! Check out our great class learning about our # PR team ' s efforts . http://t.co/wdIC2dEkX	RT @ hck2 : It 's time for our # HCK2U spring session ! Check out our great class learning about our # PR team 's efforts . http://t.co/wdIC2dEkX
RT @ jonkarl : GOP source : Deal is 39 billion in cuts and no planned parenthood restrictions . Boehner : this is the best deal we could get	RT @ jonkarl : GOP source : Deal is 39 billion in cuts and no planned parenthood restrictions . Boehner :  this is the best deal we could get
Packed up all my handbags last weekend for the move . Now I miss them and want to dig them back out . # problem	Packed up all my handbags last weekend for the move . Now I miss them and want to dig them back out . # problem
I worked for an architecture magazine as their web editor for a few years , and also did some freelance work , which I continue . # ConnectCha	I worked for an architecture magazine as their web editor for a few years , and also did some freelance work , which I continue . # ConnectCha
Switching back between # Oscars tweeting and the final hour of my first-ever Ebay auction ( buying , not selling ) . It ' s all so exciting	Switching back between # Oscars tweeting and the final hour of my first-ever Ebay auction ( buying , not selling) . It 's all so exciting
Gram and @ shamburgesa , fixin ' our annual Christmas Eve lunch . Waiting on cousins and the fried turkey to arrive . http://t.co/RAn4xWb	Gram and @ shamburgesa , fixin ' our annual Christmas Eve lunch . Waiting on cousins and the fried turkey to arrive . http://t.co/RAn4xWb
@ jllovett I'm sad about leaving , but equally excited about working at the Register . Getting back to reporting . # withdrawa	@ jllovett I'm sad about leaving , but equally excited about working at the Register . Getting back to reporting . # withdrawa
Taking the role of citizen journalist . Let ' s see how this goes . Wasn't sure if I could join the press line ... # sb9 # texa	Taking the role of citizen journalist . Let 's see how this goes . Wasn't sure if I could join the press line ... # sb9 # texa
@ jghellum Yeah , it ' s an awesome gig . I'm really excited about the work . How ' s Azcentral ? ( and belated congrats on Luke and the bee !	@ jghellum Yeah , it 's an awesome gig . I'm really excited about the work . How 's Azcentral ? ( and belated congrats on Luke and the bee !
About to embark on my last exam and then I'm going to Banditos with @ katiesimon33 and @ TheKicker0	About to embark on my last exam and then I'm going to Banditos with @ katiesimon33 and @ TheKicker0
@ mlpatterson89 awesome ! Grad school is pretty cool and my internship is great too . I'm learning a lot ! How ' s Lubbock life ? Still boring	@ mlpatterson89 awesome ! Grad school is pretty cool and my internship is great too . I'm learning a lot ! How 's Lubbock life ? Still boring
@ omaureen no , he just moved in below my apartment that I'm moving OUT of tomorrow . Thank god	@ omaureen no , he just moved in below my apartment that I'm moving OUT of tomorrow . Thank god
I need to start planning an epic leaving Miami Weekend - Vagabond , buck15 , Discotekka . Discuss amongst yourselves	I need to start planning an epic leaving Miami Weekend - Vagabond , buck15 , Discotekka . Discuss amongst yourselves
CORRECTION : Big thanks to EEJF for its $100k grant to @ ONA so we can create virtual training modules : http://t.co/dCe8YohUsI # ON	CORRECTION : Big thanks to EEJF for its $100k grant to @ ONA so we can create virtual training modules : http://t.co/dCe8YohUsI # ON
RT @ SirPatStew : How very pleasant Berkeley is , climate , architecture , landscape , FOOD . We should all be so lucky to live here	RT @ SirPatStew : How very pleasant Berkeley is , climate , architecture , landscape , FOOD . We should all be so lucky to live here
Cute post , girl ! RT @ KrystalSchlegel : Watch my interview with Alli Webb- Founder of @ thedrybar -- > http://t.co/vLNIOxk	Cute post , girl ! RT @ KrystalSchlegel : Watch my interview with Alli Webb- Founder of @ thedrybar -- &gt; http://t.co/vLNIOxk
@ Dyverse_Steele I also started collecting # avatar stories if you want to share your @ SecondLife or # virtualworld , # mmo story contact me . # f	@ Dyverse_Steele I also started collecting # avatar stories if you want to share your @ SecondLife or # virtualworld , # mmo story contact me . # f
Read all about it ! My internship experience at its best ! MedTech Guidelines and an Unexpected Emergency http://t.co/mh2MlxRa	Read all about it ! My internship experience at its best !  MedTech Guidelines and an Unexpected Emergency http://t.co/mh2MlxRa
@ MeetTheNewRich sorry , i cant right now - im on book deadline till January ( but all the best with your project !	@ MeetTheNewRich sorry , i cant right now - im on book deadline till January ( but all the best with your project !
This is what I'm coming home to . Thank goodness for A/C . // RT @ startelegram : Dress light . Another hot one in DFW today - 101 or so .	This is what I'm coming home to . Thank goodness for A/C . // RT @ startelegram : Dress light . Another hot one in DFW today - 101 or so .
@ AdamBroitman indeed you have .. as Zeppelin says I just can't quit you baby . How goes life in the www.Circ.us	@ AdamBroitman indeed you have .. as Zeppelin says  I just can't quit you baby . How goes life in the www.Circ.us
RT @ RDimal : 1st time hearing the interviews from the ladies room ! Funny stuff . Wish I could hear more < Today ' s was HILARE ! Thnx 4 listenin ! & gt	RT @ RDimal : 1st time hearing the interviews from the ladies room ! Funny stuff . Wish I could hear more&lt;Today 's was HILARE ! Thnx 4 listenin ! &gt
RT @ EJHARN_07 : Happy 33rd anniversary # AngDatingDaan ! May the Lord guide our endeavors ! Building a prayerful nation through broadcast ev	RT @ EJHARN_07 : Happy 33rd anniversary # AngDatingDaan ! May the Lord guide our endeavors !  Building a prayerful nation through broadcast ev
RT @ RussianCow : The first night of Portland Startup Weekend is officially over . So much energy , I can't wait to begin building tomorrow ! ..	RT @ RussianCow : The first night of Portland Startup Weekend is officially over . So much energy , I can't wait to begin building tomorrow ! ..
RT @ moneyries : I'm hosting @ wjchat ' s stellar # wjchat tonight ! Come chat about millennials and the news starting around 8pm et at the has	RT @ moneyries : I'm hosting @ wjchat 's stellar # wjchat tonight ! Come chat about  millennials and the news  starting around 8pm et at the has
@ IHGCare Staff was great , but we had to check out early . I'm getting married today , and I need power	@ IHGCare Staff was great , but we had to check out early . I'm getting married today , and I need power
Excited to begin my UK interviews for book project . Stopping in at the @ telegraph this afternoon	Excited to begin my UK interviews for book project . Stopping in at the @ telegraph this afternoon
My Peach Pecan Muffins received high marks yesterday . :) http://t.co/zfJ8E5nGa	My Peach Pecan Muffins received high marks yesterday . :) http://t.co/zfJ8E5nGa
I aspire to someday do this ! RT @ Lily_Beth I think I'll finish my very first lip balm stick EVER before losing it ! Such an accomplishment	I aspire to someday do this ! RT @ Lily_Beth I think I'll finish my very first lip balm stick EVER before losing it ! Such an accomplishment
@ liz_kantor after my writing conference so around 645ish	@ liz_kantor after my writing conference so around 645ish
@ PRLab_BU I am currently working on a competition team for Edventure Partners Medical Reserve Corps Volunteer Challenge	@ PRLab_BU I am currently working on a competition team for Edventure Partners Medical Reserve Corps Volunteer Challenge
About to cover my first trial . I'm three states away from my comfort zone and it ' s wonderful # cuj1	About to cover my first trial . I'm three states away from my comfort zone and it 's wonderful # cuj1
@ BennettJohnT @ CMunozTheHill Would be the best . Though I did do a phone interview with @ JHerbTheHill the other day	@ BennettJohnT @ CMunozTheHill Would be the best . Though I did do a phone interview with @ JHerbTheHill the other day
@ CTrappe @ nickwestergaard @ davekean @ bobwp I'm starting to dabble with response design this week . Super promising # blogcha	@ CTrappe @ nickwestergaard @ davekean @ bobwp I'm starting to dabble with response design this week . Super promising # blogcha
So excited for my video with @ BlueCoreStudios !	So excited for my video with @ BlueCoreStudios !
+1 RT @ jenny8lee : Friend who was at Jeremy Lin ' s 38pt game vs . Lakers . I feel like Asian Americans won the Superbowl yesterday .	+1 RT @ jenny8lee : Friend who was at Jeremy Lin 's 38pt game vs . Lakers .  I feel like Asian Americans won the Superbowl yesterday .
@ LadyBaKi @ elenadanos but now I can marry her ..	@ LadyBaKi @ elenadanos but now I can marry her ..
Long break b/t class . Just long enough for my first run post fracture to a # SXSW playlist . I dislike charlie sheen , but that is # winning	Long break b/t class . Just long enough for my first run post fracture to a # SXSW playlist . I dislike charlie sheen , but that is # winning
Today I did my first HTML edits in Moodle 2 - a test before a job interview . I think it went well ! # edtec	Today I did my first HTML edits in Moodle 2 - a test before a job interview . I think it went well ! # edtec
@ DanielDPrescott Just like it ' s popularity is growing , so are the jobs . I'm just a student and was able to get a season media credential	@ DanielDPrescott Just like it 's popularity is growing , so are the jobs . I'm just a student and was able to get a season media credential
today : my birthday , tomorrow : fly to CA to start summer # GSP12 grad program @ singularityu http://t.co/lP1oHSBd , quite the # bday present ! # f	today : my birthday , tomorrow : fly to CA to start summer # GSP12 grad program @ singularityu http://t.co/lP1oHSBd , quite the # bday present ! # f
What a run . Kudos ! RT @ btrpkc : Today , somehow , my blog marks 10 years and 5,000 posts . A thank-you to all of you : http://t.co/xfdfpI4	What a run . Kudos ! RT @ btrpkc : Today , somehow , my blog marks 10 years and 5,000 posts . A thank-you to all of you : http://t.co/xfdfpI4
I worked and waited so long for my # thinkpad and now it ' s gone . I'm just going to have to save up and by another @ lenovo	I worked and waited so long for my # thinkpad and now it 's gone . I'm just going to have to save up and by another @ lenovo
@ danielptucker Check @ gotoplanb ForJournalism project as perfect example . I am big believer in local meetups/disc/trainings # onadecisio	@ danielptucker Check @ gotoplanb ForJournalism project as perfect example . I am big believer in local meetups/disc/trainings # onadecisio
Not going to lie , I kinda thought the # fuelband would be easy . After first workout , barely 1/3 way to my goal . It ' s really gonna push me	Not going to lie , I kinda thought the # fuelband would be easy . After first workout , barely 1/3 way to my goal . It 's really gonna push me
RT @ totalsratmove : Do I really have to graduate or can I just stay here for the rest of my life ? # TS	RT @ totalsratmove : Do I really have to graduate or can I just stay here for the rest of my life ? # TS
I confess , I wrote the Arsenic DNA paper to expose flaws in peer-review at subscription based journals http://t.co/rJGc9Syzx5 # seesj	I confess , I wrote the Arsenic DNA paper to expose flaws in peer-review at subscription based journals http://t.co/rJGc9Syzx5 # seesj
I'm graduating j-school in May pursuing a career in new media ! Me + my MJ mac & iphone case = the twitter dream team @ MarcJacobsInt	I'm graduating j-school in May pursuing a career in new media ! Me + my MJ mac & iphone case = the twitter dream team @ MarcJacobsInt
@ graceroberts38 NO MORE SPANISH EVER !!!!!!!! But boy did I failed that exam !!	@ graceroberts38 NO MORE SPANISH EVER !!!!!!!! But boy did I failed that exam !!
@ StorySocial Remind me to chat with you about the Schusterman Foundation . I did some work with them back in the day ..	@ StorySocial Remind me to chat with you about the Schusterman Foundation . I did some work with them back in the day ..
Oh , and you . @ MiaFarrow : Today was our wedding anniversary . How gorgeous was he ?!! http://t.co/Hl3OLhTVWT	Oh , and you .  @ MiaFarrow : Today was our wedding anniversary . How gorgeous was he ?!! http://t.co/Hl3OLhTVWT
RT @ carrieunderwood : Incredible run-through of the show tonight ! I'm literally in tears ! Hopefully we can be this great Thurs ! Can't wait !	RT @ carrieunderwood : Incredible run-through of the show tonight ! I'm literally in tears ! Hopefully we can be this great Thurs ! Can't wait !
RT @ jimschachter : @ rgibbs : Helluva two-fear today : # ONA13 award for general excellence & we hit our @ Kickstarter goal . # OMG cc : @ TexasTri	RT @ jimschachter : @ rgibbs : Helluva two-fear today : # ONA13 award for general excellence &amp; we hit our @ Kickstarter goal . # OMG cc : @ TexasTri
@ PatFlynn most definitely not the best ! i was just there recently its comically bad ( and costs $40/night	@ PatFlynn most definitely not the best ! i was just there recently its comically bad ( and costs $40/night
Done with the last final exam of my college career . # whatnow	Done with the last final exam of my college career . # whatnow
Last day at work calls for my favorite lunch from Cafe 57 . http://t.co/NMmBfmH	Last day at work calls for my favorite lunch from Cafe 57 . http://t.co/NMmBfmH
Hey @ sopranobecca you updated your Twitter . I love it ! 1st anniversary hallmark- finally making the marriage Twitter official ! hah	Hey @ sopranobecca you updated your Twitter . I love it ! 1st anniversary hallmark- finally making the marriage Twitter official ! hah
RT @ musingvirtual : I'm looking for an apartment/room/share in oakland or sf starting in january , can I get an rt	RT @ musingvirtual : I'm looking for an apartment/room/share in oakland or sf starting in january , can I get an rt
@ edutopia Got my wonderful prize pack over the weekend ! Thanks again !	@ edutopia Got my wonderful prize pack over the weekend ! Thanks again !
Where grad school intersects with my job : writing a paper on media ' s coverage in the months before the Iraq war	Where grad school intersects with my job : writing a paper on media 's coverage in the months before the Iraq war
RT @ sisiwei : # MyInternStory : Worked 1/2 the summer so I could pay for my # unpaid internship in NYC for the other 1/2 summer . http://t.co/j	RT @ sisiwei : # MyInternStory : Worked 1/2 the summer so I could pay for my # unpaid internship in NYC for the other 1/2 summer . http://t.co/j
Plan to create a whole new Twitter list based off # SmartBlackWomenOfTwitter hashtag . Loving it and inspired by the women I'm seeing	Plan to create a whole new Twitter list based off # SmartBlackWomenOfTwitter hashtag . Loving it and inspired by the women I'm seeing
@ LMeddin we achieved it in April this yea	@ LMeddin we achieved it in April this yea
is in Royal Oak attempting to do some homework and deciding how I want to celebrate my birthday tomorrow . Drag queens at Spiral anyone	is in Royal Oak attempting to do some homework and deciding how I want to celebrate my birthday tomorrow . Drag queens at Spiral anyone
After a weekend of indulgence & celebrating my new job last night , I'm very ready to get back on my clean eating/gym regimen . # staymotivate	After a weekend of indulgence &amp; celebrating my new job last night , I'm very ready to get back on my clean eating/gym regimen . # staymotivate
Working on finalizing my housing arrangements for Miami . I think I found the perfect place . Thanks to @ loritodd http://bit.ly/Y9Vh	Working on finalizing my housing arrangements for Miami . I think I found the perfect place . Thanks to @ loritodd http://bit.ly/Y9Vh
This one time I worked in a pizza parlor . 7 yrs later I'm still making delish calzones . # likeridingabike http://t.co/0415WCj	This one time I worked in a pizza parlor . 7 yrs later I'm still making delish calzones . # likeridingabike http://t.co/0415WCj
Ryan , Christy , and Gina at our graduation dinner :) @ Nick & Sam ' s http://t.co/q98MlyD	Ryan , Christy , and Gina at our graduation dinner :) @ Nick &amp; Sam 's http://t.co/q98MlyD
Trivia : Dean Singleton cost me my first paying job in journalism , buying The Houston Post & closing it days after I got an internship there	Trivia : Dean Singleton cost me my first paying job in journalism , buying The Houston Post &amp; closing it days after I got an internship there
Bad news : lost my ring at security : ' ( Good news : Kenny Loggins ' Danger Zone in the termina	Bad news : lost my ring at security :' ( Good news : Kenny Loggins ' Danger Zone in the termina
Today I'm interviewing author ( former Harpers EIC/ Vogue Sr . Editor ) @ katebetts about her new book @ EverydayIcon at @ neimanmarcus # Dalla	Today I'm interviewing author ( former Harpers EIC/ Vogue Sr . Editor ) @ katebetts about her new book @ EverydayIcon at @ neimanmarcus # Dalla
Think I'll finish this thesis draft , send it off for revisions , and then make a cake . # finals201	Think I'll finish this thesis draft , send it off for revisions , and then make a cake . # finals201
FINALLY ordered the wedding invites . Hope @ ChrisTraister will still marry me - that was my ONE area of bridezilla-ness	FINALLY ordered the wedding invites . Hope @ ChrisTraister will still marry me - that was my ONE area of bridezilla-ness
Life news : I'm going to be moving to San Francisco to cover Facebook , Twitter , LinkedIn and startups @ BloombergNew	Life news : I'm going to be moving to San Francisco to cover Facebook , Twitter , LinkedIn and startups @ BloombergNew
I'll be attending @ sxsw Style X March 18 & 19th ! Who else is going to be in ATX for the inaugural Style conference	I'll be attending @ sxsw Style X March 18 & 19th ! Who else is going to be in ATX for the inaugural Style conference
@ DJWestfall considering I'm a granada intern I'm assuming I will probably be there . Its a pretty unique lineup as well ..	@ DJWestfall considering I'm a granada intern I'm assuming I will probably be there . Its a pretty unique lineup as well ..
Pedicures on a Friday afternoon after getting sushi for lunch with mom . Can't wait for tonight ' s anniversary dinner with my best friend :	Pedicures on a Friday afternoon after getting sushi for lunch with mom . Can't wait for tonight 's anniversary dinner with my best friend :
Feels like I have 3 jobs . Oh wait ! # ikindado # gradstudentprob	Feels like I have 3 jobs . Oh wait ! # ikindado # gradstudentprob
More free food than I can handle !! Free Chipotle Burrito Day for @ NickelodeonTV employees ! Best # internship EVER	More free food than I can handle !! Free Chipotle Burrito Day for @ NickelodeonTV employees ! Best # internship EVER
My goal today is to finish my book and not care about anything else # perfec	My goal today is to finish my book and not care about anything else # perfec
Internship starts tomorrow @ imcsquared ! I am so pumped ! @ haleygate @ MatthewVe	Internship starts tomorrow @ imcsquared ! I am so pumped ! @ haleygate @ MatthewVe
RT @ dailytarheel : RT @ dthschwartz Lease is signed on our move to Rosemary Stree	RT @ dailytarheel : RT @ dthschwartz Lease is signed on our move to Rosemary Stree
RT @ mattwaite : Last calculus class complete . I am a final away from completing a 21-year journey out of math phobia	RT @ mattwaite : Last calculus class complete . I am a final away from completing a 21-year journey out of math phobia
I made a new achievement : `Big Village` . Try to beat me in the # iPad game The Tribez ! http://t.co/siWp7GDJ77 # ipadgames , # gameinsigh	I made a new achievement : `Big Village` . Try to beat me in the # iPad game The Tribez ! http://t.co/siWp7GDJ77 # ipadgames , # gameinsigh
I'll be able to say this one day .. RT @ maggielannon : Purchased my ski pass for the season . Couldn't be more excited for the Colorado winter	I'll be able to say this one day .. RT @ maggielannon : Purchased my ski pass for the season . Couldn't be more excited for the Colorado winter
RT @ JoyceCarolOates : Ironic that I am a judge for the Truman Capote award when Capote in a druggy interview said he hated me & that I shou	RT @ JoyceCarolOates : Ironic that I am a judge for the Truman Capote award when Capote in a druggy interview said he hated me &amp; that I shou
RT @ aksingh77 : An incredible new milestone for Google Enterprise - I'm proud to announce that we now have 5M businesses using # googleapp ..	RT @ aksingh77 : An incredible new milestone for Google Enterprise - I'm proud to announce that we now have 5M businesses using # googleapp ..
@ nealthea and I should be in charge of picking the music for ComArts graduation . Dirty eletro all the way	@ nealthea and I should be in charge of picking the music for ComArts graduation . Dirty eletro all the way
Such a klutz . Leaving for work trip tomorrow AM , have not packed , & I lock my keys in the trunk at Walmart . Waiting on locksmith . # goodstar	Such a klutz . Leaving for work trip tomorrow AM , have not packed , &amp; I lock my keys in the trunk at Walmart . Waiting on locksmith . # goodstar
@ mccanner @ digiphile ( Mark , from what I've heard , is a great guy , too , so I wonder how this role has bent him into this position .	@ mccanner @ digiphile ( Mark , from what I've heard , is a great guy , too , so I wonder how this role has bent him into this position .
Just got out of my management of strat comm class with @ AlexLBlum , & @ DHicks37 . Nervous about that class , but excited too	Just got out of my management of strat comm class with @ AlexLBlum , & @ DHicks37 . Nervous about that class , but excited too
I made a new achievement : `Getter` . Try to beat me in the # iPad game The Tribez ! http://t.co/siWp7GDJ77 # ipadgames , # gameinsigh	I made a new achievement : `Getter` . Try to beat me in the # iPad game The Tribez ! http://t.co/siWp7GDJ77 # ipadgames , # gameinsigh
This job has its perks . Like , me-time while waiting for prison visit . @ my fav cafe in changi	This job has its perks . Like , me-time while waiting for prison visit . @ my fav cafe in changi
It ' s officially been one year since I moved from # Virginia to # Phoenix . Wow does time fly . Proud to be part of the @ 12news/@ azcentral tea	It 's officially been one year since I moved from # Virginia to # Phoenix . Wow does time fly . Proud to be part of the @ 12news/@ azcentral tea
RT @ davidortiz : To thank you the fans for your support and to celebrate staying in Boston I will be sending a signed ball to a random fo ..	RT @ davidortiz : To thank you the fans for your support and to celebrate staying in Boston I will be sending a signed ball to a random fo ..
It ' s our anniversary ! 12 years in love . Married 3 years . Together forever . Love you , @ ProfGreen http://t.co/ADpp8IpYF	It 's our anniversary ! 12 years in love . Married 3 years . Together forever . Love you , @ ProfGreen http://t.co/ADpp8IpYF
RT @ DwightHoward : I've decided to become a member of the Houston Rockets . I feel its the best place for me and I am excited ( cont ) http://	RT @ DwightHoward : I've decided to become a member of the Houston Rockets . I feel its the best place for me and I am excited ( cont ) http://
@ austinprentice same here . on the plus side i made lunch AND dinner . semester is heading in a good direction so fa	@ austinprentice same here . on the plus side i made lunch AND dinner . semester is heading in a good direction so fa
@ davidwenger Thanks much . My daughter @ texasjswin is graduating from Cockrell on Friday . We'll be on the Mall as well on Saturday . Hook ' em	@ davidwenger Thanks much . My daughter @ texasjswin is graduating from Cockrell on Friday . We'll be on the Mall as well on Saturday . Hook ' em
@ kellidev I tend to have my own marathons each weekend . # oops	@ kellidev I tend to have my own marathons each weekend . # oops
To celebrate my 1000th follower , I will let anyone on Twitter retweet anything I have ever tweeted . I'm at 998 now . Will you be # 1000	To celebrate my 1000th follower , I will let anyone on Twitter retweet anything I have ever tweeted . I'm at 998 now . Will you be # 1000
Sorry for the sporadic tweeting . My internet access here is wonky , so I've been feeling quite detached from the Twitterverse . # isolatio	Sorry for the sporadic tweeting . My internet access here is wonky , so I've been feeling quite detached from the Twitterverse . # isolatio
At the gym resting Inbetween sets and I randomly start singing # outloud take time with a wounded hand ~	At the gym resting Inbetween sets and I randomly start singing # outloud  take time with a wounded hand~
@ JoyNguyen niiice , I was watching tosh . 0 tooo ! & I'm excited about Walking Dead too !!!! Miss ya	@ JoyNguyen niiice , I was watching tosh . 0 tooo ! & I'm excited about Walking Dead too !!!! Miss ya
My first MA assignment - Today ' s the day ! First day of class on the road to my Master ' s degree . I've already check ... http://t.co/SZVaakl	My first MA assignment - Today 's the day ! First day of class on the road to my Master 's degree . I've already check ... http://t.co/SZVaakl
@ JeremyLittau But it ' s beneficial procrastination . Would be like me procrastinating by finishing my dissertation	@ JeremyLittau But it 's beneficial procrastination . Would be like me procrastinating by finishing my dissertation
Last day of my internship . Last Homebar tonight . I hate it . # emotion	Last day of my internship . Last Homebar tonight . I hate it . # emotion
Despite @ AmericanAir ' s best efforts , I made it ! (@ George Bush International Airport ( IAH ) w/ 60 others ) http://t.co/5R0qZbOUz	Despite @ AmericanAir 's best efforts , I made it ! (@ George Bush International Airport ( IAH ) w/ 60 others ) http://t.co/5R0qZbOUz
@ CYTaylor found the blogpost I wrote in 2010 on robots in the workplace http://t.co/owOqsIkU BTW : gotta resume the blog - miss it a lot	@ CYTaylor found the blogpost I wrote in 2010 on robots in the workplace http://t.co/owOqsIkU BTW : gotta resume the blog - miss it a lot
@ ScottTrabandt You got it man . Between mothers day and my 10th anniversary , life has been getting in the way of my soccer playing . : -	@ ScottTrabandt You got it man . Between mothers day and my 10th anniversary , life has been getting in the way of my soccer playing . : -
RT @ omarg : We're saying goodbye today to 17 amazing colleagues . Bittersweet because we're sad , but also grateful and honored to have worke	RT @ omarg : We're saying goodbye today to 17 amazing colleagues . Bittersweet because we're sad , but also grateful and honored to have worke
I couldn't ask for a better start on my # birthday ! (@ Gaia Flow Yoga ) http://t.co/Dau7KTl	I couldn't ask for a better start on my # birthday ! (@ Gaia Flow Yoga ) http://t.co/Dau7KTl
I have made a separate friendship to-do list Google doc for basically every NYC friend & visitor . This is starting to get out of hand	I have made a separate friendship to-do list Google doc for basically every NYC friend &amp; visitor . This is starting to get out of hand
I HAVE ARRIVED ! Let the new chapter of my life oh-ficially begin ! :-) (@ North Campus Crossing ) http://t.co/quyUT3w	I HAVE ARRIVED ! Let the new chapter of my life oh-ficially begin ! :-) (@ North Campus Crossing ) http://t.co/quyUT3w
I just caved and joined LinkedIn and created my professional profile . Cave with me ? http://t.co/nJDWf93U # i	I just caved and joined LinkedIn and created my professional profile . Cave with me ? http://t.co/nJDWf93U # i
! MT @ betsyscribeindc : my 3 years at FishbowlDC have been the perfect storm . Onto new adventures . Stay tuned ..	! MT @ betsyscribeindc : my 3 years at FishbowlDC have been the perfect storm . Onto new adventures . Stay tuned ..
@ be3d When I finish the dissertation , I'll pick up some coding . I owe it to my students . Not enough that I know my way around WordPress	@ be3d When I finish the dissertation , I'll pick up some coding . I owe it to my students . Not enough that I know my way around WordPress
RT @ ajcorchado : My interview today on NPR ' s Fresh Air : # MidnightinMexico @ nprfreshair .! http://t.co/PU26DiO0Nb . Enjoyed it	RT @ ajcorchado : My interview today on NPR 's Fresh Air : # MidnightinMexico @ nprfreshair .! http://t.co/PU26DiO0Nb . Enjoyed it
@ burgeoningbaker Ha ! Well , I'm glad I have a fulltime job . No more interning	@ burgeoningbaker Ha ! Well , I'm glad I have a fulltime job . No more interning
I just won 10 Swag Bucks by searching the web at http://t.co/EDGKMLpuKX http://t.co/59CtpO0n6	I just won 10 Swag Bucks by searching the web at http://t.co/EDGKMLpuKX http://t.co/59CtpO0n6
just created an Axemunkee page ( yeah , finally ) on YouTube . Got some rare performance vid of my time in Arras , France	just created an Axemunkee page ( yeah , finally ) on YouTube . Got some rare performance vid of my time in Arras , France
@ Kumachine My pleasure . Part of my work-release program	@ Kumachine My pleasure . Part of my work-release program
@ AsiaChloeBrown Re-strategizing and restructuring but I'm happy with what we have so far . The feedback has been great . I'm excited . :	@ AsiaChloeBrown Re-strategizing and restructuring but I'm happy with what we have so far . The feedback has been great . I'm excited . :
I am Lorraine Esposito , professional coach and coach trainer . Welcome to my school . http://t.co/M32vTSlIk	I am Lorraine Esposito , professional coach and coach trainer . Welcome to my school . http://t.co/M32vTSlIk
@ joshuabuckley How'd tonight go ? Our game isn't until 8:30 p.m. Lots of time to finish work & see the city	@ joshuabuckley How'd tonight go ? Our game isn't until 8:30 p.m. Lots of time to finish work & see the city
Just printed out my Spanish paper and stapled it , ready to turn in tomorrow . # productivity # ohye	Just printed out my Spanish paper and stapled it , ready to turn in tomorrow . # productivity # ohye
I just won a Shakespeare action figure for bringing in the worst criticism of Twelfth Night . # soemerso	I just won a Shakespeare action figure for bringing in the worst criticism of  Twelfth Night . # soemerso
We have our first arms race reference at today ' s @ NetCaucusAC # donottrack panel . Over-under is 5 .	We have our first  arms race  reference at today 's @ NetCaucusAC # donottrack panel . Over-under is 5 .
RT @ Tawnell : Too cool . I have a friend in the swing state of Colorado who just received a phone call from Mitt Romney -- not a robocall , ..	RT @ Tawnell : Too cool . I have a friend in the swing state of Colorado who just received a phone call from Mitt Romney -- not a robocall , ..
I wonder if the new Mac Pro saves the desktop . I know I want one , though I have zero need for one . It looks awesome . # WWD	I wonder if the new Mac Pro saves the desktop . I know I want one , though I have zero need for one . It looks awesome . # WWD
So basically the only way LSU can make it to the Natuonal Championship is if we beat Alabama and win the SEC championship game	So basically the only way LSU can make it to the Natuonal Championship is if we beat Alabama and win the SEC championship game
@ ourunningirl Meet my wife Sunday @ sun87day . We've been married since 1989 . She is the greatest wife ever	@ ourunningirl Meet my wife Sunday @ sun87day . We've been married since 1989 . She is the greatest wife ever
The valedictorian at my sister ' s HS graduation compared the class to honey badgers and closed with a Snoop Dogg quote . Quality	The valedictorian at my sister 's HS graduation compared the class to honey badgers and closed with a Snoop Dogg quote . Quality
Went for a short run . Might as well have been wearing a sign that says I grew up in South Florida !	Went for a short run . Might as well have been wearing a sign that says  I grew up in South Florida !
Start training for my half marathon in DC today !!	Start training for my half marathon in DC today !!
My Auntie is selling # HCG !!!! It ' s a new diet supplement and it really works ! I lost 20 lbs in 35 days . Check it out -- www.hcgonlinesite.co	My Auntie is selling # HCG !!!! It 's a new diet supplement and it really works ! I lost 20 lbs in 35 days . Check it out -- www.hcgonlinesite.co
RT @ brenden3lee : ditto ! RT @ KWilsonPR : Dear # PR pros who graciously follow my tweets : I will soon have my 2nd degree & will need a job ..	RT @ brenden3lee : ditto ! RT @ KWilsonPR : Dear # PR pros who graciously follow my tweets : I will soon have my 2nd degree & will need a job ..
I can't believe I'm engaged @ LBawlzz @ cchambs @ jennifertraver @ mbutler89 http://t.co/bbHfCh	I can't believe I'm engaged @ LBawlzz @ cchambs @ jennifertraver @ mbutler89 http://t.co/bbHfCh
This year for my birthday ( today ) , I just want J-Lo to put her leg away . It ' s starting to give me nightmares . # Grammytweet	This year for my birthday ( today) , I just want J-Lo to put her leg away . It 's starting to give me nightmares . # Grammytweet
It ' s snowing in Oklahoma ! Hooray ! Though I do hope it is the nice kind of snow that still lets me get to my interview tomorrow # itissnowin	It 's snowing in Oklahoma ! Hooray ! Though I do hope it is the nice kind of snow that still lets me get to my interview tomorrow # itissnowin
@ JoyNguyen I sure did get an instagram , Already following you . # finallyAndroidcatchingu	@ JoyNguyen I sure did get an instagram , Already following you . # finallyAndroidcatchingu
I can't imagine hating another co-worker . I've had so many good experiences with the people I've worked with in my life . I feel # luck	I can't imagine hating another co-worker . I've had so many good experiences with the people I've worked with in my life . I feel # luck
We're excited to host @ treybowles and @ natalieblanken at our # jpreneur class on Tuesday : http://t.co/DI046diII	We're excited to host @ treybowles and @ natalieblanken at our # jpreneur class on Tuesday : http://t.co/DI046diII
I thought Texas was humid . Until I moved to North Carolina . # alittlewindwouldbenic	I thought Texas was humid . Until I moved to North Carolina . # alittlewindwouldbenic
And my final piece to go in my collection . The # LegendOfKorra Spirit Parade art . Thanks @ AgentofShield for this # yay http://t.co/TvSBdrdlU	And my final piece to go in my collection . The # LegendOfKorra Spirit Parade art . Thanks @ AgentofShield for this # yay http://t.co/TvSBdrdlU
Not only did I win an awesome autographed Kyle Williams helmet in a raffle , but got @ annastolz ' s auto-g , too # Buffalo http://t.co/iK74gkz1s	Not only did I win an awesome autographed Kyle Williams helmet in a raffle , but got @ annastolz 's auto-g , too # Buffalo http://t.co/iK74gkz1s
@ danielpetty @ TheBigKlosowski I like the app a lot . And it was fun to watch my mom , who reads paper DP daily , navigate her way through it	@ danielpetty @ TheBigKlosowski I like the app a lot . And it was fun to watch my mom , who reads paper DP daily , navigate her way through it
@ Personalsfacts Hey hey ! I'm in the final stages of my 2nd album , A Better Picture ! Click here to be a part of it ! http://t.co/fGrgxMY	@ Personalsfacts Hey hey ! I'm in the final stages of my 2nd album ,  A Better Picture ! Click here to be a part of it ! http://t.co/fGrgxMY
I just became the mayor of Philadelphia 76ers HQ on @ foursquare ! http://t.co/z84Aow6	I just became the mayor of Philadelphia 76ers HQ on @ foursquare ! http://t.co/z84Aow6
Hangin with Friends is like a Rorschach test . _ l u t e . I guess glute . Word was flute . duh	Hangin with Friends is like a Rorschach test . _ l u t e . I guess  glute . Word was  flute . duh
I hope I win the free headphones from # solrepublicwitness @ # hypehotel ! SXSW giveaways are no joke ! : -	I hope I win the free headphones from # solrepublicwitness @ # hypehotel ! SXSW giveaways are no joke ! : -
First day working with God ' s Love , We Deliver ! So pumped . @ aliyaprasla @ lovelyamiee	First day working with God 's Love , We Deliver ! So pumped . @ aliyaprasla @ lovelyamiee
Getting ready to interview @ timhalperin for @ samanthacang & my last day of work w/ @ laurastillo . Can't wait to start again in Sept # GoodLif	Getting ready to interview @ timhalperin for @ samanthacang & my last day of work w/ @ laurastillo . Can't wait to start again in Sept # GoodLif
@ mdbarber This year we took the kids to Disney World for a week after 2 years of planning . ( Actually , we just got back earlier today .	@ mdbarber This year we took the kids to Disney World for a week after 2 years of planning . ( Actually , we just got back earlier today .
@ mjenkins Thanks ! You have no idea how excited I am to work with @ keithwj Totally stoked	@ mjenkins Thanks ! You have no idea how excited I am to work with @ keithwj Totally stoked
Got to be a part of one of my all-time BFF ' s weddings last night . Congrats , @ ktedrick ! You were a beautiful bride	Got to be a part of one of my all-time BFF 's weddings last night . Congrats , @ ktedrick ! You were a beautiful bride
RT @ TheTamiJ : I am now a senior in college . One more year .	RT @ TheTamiJ : I am now a senior in college . One more year .
I just unlocked the Level 2 Mall Rat badge on @ foursquare ! In it to win it ! http://t.co/icdu1ky	I just unlocked the Level 2  Mall Rat  badge on @ foursquare ! In it to win it ! http://t.co/icdu1ky
4.0 on my Art History exam . Paula Scher later . Good day	4.0 on my Art History exam . Paula Scher later . Good day
@ TonyRomm @ LoganDobson I'm here all night . Or at least until my funding runs out	@ TonyRomm @ LoganDobson I'm here all night . Or at least until my funding runs out
@ AuerbachKeller seriously : after that review , I'll follow your work forever more . The experience of reading that piece was an Idyll	@ AuerbachKeller seriously : after that review , I'll follow your work forever more . The experience of reading that piece was an Idyll
Bennett : I end my tenure as commissioner very proud of the work weve done . I end my tenure with my head held very high . # inedcha	Bennett :  I end my tenure as commissioner very proud of the work weve done . I end my tenure with my head held very high . # inedcha
RT @ beckyblanton : I nominate @ coachlorraine for a Shorty Award in # Coach of the Year because ... she has done AMAZING things for my biz ! h ..	RT @ beckyblanton : I nominate @ coachlorraine for a Shorty Award in # Coach of the Year because ... she has done AMAZING things for my biz ! h ..
I've just entered this awesome # mancavefiller giveaway to win CASH for my dad for Father ' s Day ! http://t.co/SDKZ0299 http://t.co/YAFJkrA	I've just entered this awesome # mancavefiller giveaway to win CASH for my dad for Father 's Day ! http://t.co/SDKZ0299 http://t.co/YAFJkrA
I made a new achievement : `Gatherer` . Try to beat me in the # iPad game The Tribez ! http://t.co/siWp7GDJ77 # ipadgames , # gameinsigh	I made a new achievement : `Gatherer` . Try to beat me in the # iPad game The Tribez ! http://t.co/siWp7GDJ77 # ipadgames , # gameinsigh
RT @ collegedemsofbc : Up early and headed to New Hampshire to help re-elect our president ! @ OFA_NH # Obama2012 # mapol	RT @ collegedemsofbc : Up early and headed to New Hampshire to help re-elect our president ! @ OFA_NH # Obama2012 # mapol
Spent all day applying for jobs , asserting my commitment to teaching excellence . Ignored lesson planning . # academi	Spent all day applying for jobs , asserting my  commitment to teaching excellence . Ignored lesson planning . # academi
@ _Swhitty or creepy ? hahaha . i just started going there and i LOVE it	@ _Swhitty or creepy ? hahaha . i just started going there and i LOVE it
@ colinize @ maddimasino @ agardina today is a great day for it . Rach and I got married 13 yrs ago today , and look how it turned out	@ colinize @ maddimasino @ agardina today is a great day for it . Rach and I got married 13 yrs ago today , and look how it turned out
My divorce is final in 35 days . # phoneconvosatFriendlysWestBa	 My divorce is final in 35 days . # phoneconvosatFriendlysWestBa
Great advice ! RT @ kstorres : Friend ' s advice for my nerves about internship interview : Eat things that are kind to your belly . NO CHORIZO	Great advice ! RT @ kstorres : Friend 's advice for my nerves about internship interview :  Eat things that are kind to your belly . NO CHORIZO
My work at @ NiemanLab is done , close up shop everybody , drinks are on me cc : @ AdrienneLaF http://t.co/pbUpPLmO3	My work at @ NiemanLab is done , close up shop everybody , drinks are on me cc : @ AdrienneLaF http://t.co/pbUpPLmO3
I love my involvement with the NFL . Monday , I'll be there for the announcement about the partnership with G . E .... http://t.co/cqBpvH3lf	I love my involvement with the NFL . Monday , I'll be there for the announcement about the partnership with G . E .... http://t.co/cqBpvH3lf
Our kids are looking forward to @ WaltDisneyWorld ' s # NotSoScary Halloween in a few weeks . Wife and I also excited :) http://t.co/OPkemibbU	Our kids are looking forward to @ WaltDisneyWorld 's # NotSoScary Halloween in a few weeks . Wife and I also excited :) http://t.co/OPkemibbU
Trying desperately to stay awake for the Grey ' s Anatomy finale . The pain meds I took are making it difficult . # wisdomteet	Trying desperately to stay awake for the Grey 's Anatomy finale . The pain meds I took are making it difficult . # wisdomteet
Scotland for the weekend ? Yes please . Plus , booked my train ticket to Brussels & Amsterdam ! # winnin	Scotland for the weekend ? Yes please . Plus , booked my train ticket to Brussels & Amsterdam ! # winnin
I'm feeling it too ! @ carrieblazina : Going to the gym every day for the next five years . Thanks , Christmas food	I'm feeling it too ! @ carrieblazina : Going to the gym every day for the next five years . Thanks , Christmas food
@ ChrisLKeller Yeah , I went KyngChaos . Just had to get it working	@ ChrisLKeller Yeah , I went KyngChaos . Just had to get it working
The perfunctory I graduated today ! tweet . Congratulations , all you SMU-ers ( and @ KiddTW too )	The perfunctory  I graduated today ! tweet . Congratulations , all you SMU-ers ( and @ KiddTW too )
Come hear my & @ SarahPrindle ' s paper next ! # scms1	Come hear my & @ SarahPrindle 's paper next ! # scms1
Met the new @ DallasSouthNews team at the @ SMU j-school on Friday ... came away excited about this next step in our partnership	Met the new @ DallasSouthNews team at the @ SMU j-school on Friday ... came away excited about this next step in our partnership
Chilling in Fondren with two extremely studious friends . I have plenty of work to do too which is why I'm on Facebook and Twitter	Chilling in Fondren with two extremely studious friends . I have plenty of work to do too which is why I'm on Facebook and Twitter
Hello Europe : I started a daily newsletter for intriguing links . https://t.co/zNJxlcZdix Suggestions to : amadrigal@ theatlantic . co	Hello Europe : I started a daily newsletter for intriguing links . https://t.co/zNJxlcZdix Suggestions to : amadrigal@ theatlantic . co
Enjoying my last day of tv contol over @ Wayne_Parrott Tour de France starts tomorrow along with 24 hour coverage of lance armstong ' s rear	Enjoying my last day of tv contol over @ Wayne_Parrott Tour de France starts tomorrow along with 24 hour coverage of lance armstong 's rear
RT @ Amoswtlcindy : I'm hearing a State Bd of Educ member bragging about achievement gap improvement . Looking at the NAEP , I don't see the s	RT @ Amoswtlcindy : I'm hearing a State Bd of Educ member bragging about achievement gap improvement . Looking at the NAEP , I don't see the s
Finished up my Ask Me Anything for @ reddit . I was nervous but everyone had great questions ! Now back to prepping for tomorrow ' s workshop	Finished up my  Ask Me Anything  for @ reddit . I was nervous but everyone had great questions ! Now back to prepping for tomorrow 's workshop
I made a new achievement : `Hoarder` . Try to beat me in the # iPad game The Tribez ! http://t.co/siWp7GDJ77 # ipadgames , # gameinsigh	I made a new achievement : `Hoarder` . Try to beat me in the # iPad game The Tribez ! http://t.co/siWp7GDJ77 # ipadgames , # gameinsigh
In case you missed it , check out my first experience helping teach a cooking class with @ sandralatinista : http://bit.ly/fN9rI	In case you missed it , check out my first experience helping teach a cooking class with @ sandralatinista : http://bit.ly/fN9rI
As we near the Maryland/Delaware state line , I see the sun for the first time on my trip . # finally https://t.co/0wZvCQuAs	As we near the Maryland/Delaware state line , I see the sun for the first time on my trip . # finally https://t.co/0wZvCQuAs
@ palafo A former reporter I interviewed today was punished by being moved to obits . But that was 40+ years ago . Personally , I love ' em	@ palafo A former reporter I interviewed today was  punished  by being moved to obits . But that was 40+ years ago . Personally , I love ' em
@ ashleighjoelle that ' s awesome ! I'm doing higher ed with an emphasis in student development . Hopefully it will help me move up	@ ashleighjoelle that 's awesome ! I'm doing higher ed with an emphasis in student development . Hopefully it will help me move up
@ sisiwei when I was in high school , we nerds were dialing up BBSes on 14.4 k baud modems	@ sisiwei when I was in high school , we nerds were dialing up BBSes on 14.4 k baud modems
@ Heradel Oh yeah , I'm engaged	@ Heradel Oh yeah , I'm engaged
Health paper is DONE ! Not quite as good as @ shannon_whitney , but I'm happy enough	Health paper is DONE ! Not quite as good as @ shannon_whitney , but I'm happy enough
I finally did it . I finally subscribed to @ womensweardaily ! # presenttomysel	I finally did it . I finally subscribed to @ womensweardaily ! # presenttomysel
@ brittjmurphy @ LizDeane I have a student visa that allowed me to work . I've heard that regular work visas are pretty difficult to get ..	@ brittjmurphy @ LizDeane I have a student visa that allowed me to work . I've heard that regular work visas are pretty difficult to get ..
Ready to sport my badge all weekend ! txsc # workingisfun @ Hyatt Regency Austin http://t.co/U9yGh92GD	Ready to sport my badge all weekend ! txsc # workingisfun @ Hyatt Regency Austin http://t.co/U9yGh92GD
I made a new achievement : `Leader` . Try to beat me in the # iPad game The Tribez ! http://t.co/siWp7GDJ77 # ipadgames , # gameinsigh	I made a new achievement : `Leader` . Try to beat me in the # iPad game The Tribez ! http://t.co/siWp7GDJ77 # ipadgames , # gameinsigh
A win is a win . Not the prettiest win , but I'll take it . # ponyu	A win is a win . Not the prettiest win , but I'll take it . # ponyu
Glory to God ! Campaigns finished . I am literally living a dream right now	Glory to God ! Campaigns finished . I am literally living a dream right now
I can sleep when I graduate . Until then , onward # journalism	I can sleep when I graduate . Until then , onward # journalism
Whew , what a day ... Made it to Tuscaloosa , AL . Calling it a night , finally ! Tomorrow I get to see @ SpikyProvolone # squea	Whew , what a day ... Made it to Tuscaloosa , AL . Calling it a night , finally ! Tomorrow I get to see @ SpikyProvolone # squea
About to pee myself with excitement over going to see @ ladygaga in # PDX tonight ! Practicing my lightning bolt makeup . # youthinkimjokin	About to pee myself with excitement over going to see @ ladygaga in # PDX tonight ! Practicing my lightning bolt makeup . # youthinkimjokin
Just watched a French film . . . IN FRENCH . I'll take my cultured award now please and thank you # subtitle	Just watched a French film . . . IN FRENCH . I'll take my cultured award now please and thank you # subtitle
@ zagush after I move in on the 30th , yes	@ zagush after I move in on the 30th , yes
Planning the sessions I'll attend at the ACP/CMA National College Media Convention (@ collegemedia13 ) in New Orleans . # excite	Planning the sessions I'll attend at the ACP/CMA National College Media Convention (@ collegemedia13 ) in New Orleans . # excite
Doing some last-minute packing for # newsfoo . So excited . Don't know if I'll be able to sleep tonight	Doing some last-minute packing for # newsfoo . So excited . Don't know if I'll be able to sleep tonight
@ tumbyMe @ eriks Thank you . And I won't lie : I hope you are both in my position some time in the coming years	@ tumbyMe @ eriks Thank you . And I won't lie : I hope you are both in my position some time in the coming years
Chillin ' like a boss . Tomorrow we do work # MakeMoney # WorkHardPlayHar	Chillin ' like a boss . Tomorrow we do work # MakeMoney # WorkHardPlayHar
. @ diamondsworlddd upon seeing a photo of new look I want : You trying to get married ! # ican	. @ diamondsworlddd upon seeing a photo of new look I want :  You trying to get married ! # ican
@ arielsinha no need for repayment it is the least we could for such a wonderful friend like you	@ arielsinha no need for repayment it is the least we could for such a wonderful friend like you
Signs I'm getting old : a kid said thank you ma'am to me at the gym today . And I hurt my knee running . # lif	Signs I'm getting old : a kid said thank you ma'am to me at the gym today . And I hurt my knee running . # lif
Happy Cinco De Mayo ! Ole ! Now that i had my roomie block me frm my own fbook for exams , this is my only outle	Happy Cinco De Mayo ! Ole ! Now that i had my roomie block me frm my own fbook for exams , this is my only outle
Just bought a copy of my fourth grade textbook , The Land Called Alabama ( Copyright 1958 ) , at Reed Books in B'ham . @ angermonsoo	Just bought a copy of my fourth grade textbook , The Land Called Alabama ( Copyright 1958) , at Reed Books in B'ham. @ angermonsoo
The first step towards a new future for @ SigEp_KSDelta began tonight . I can't wait to see what ' s in store for us . # DamnProu	The first step towards a new future for @ SigEp_KSDelta began tonight . I can't wait to see what 's in store for us . # DamnProu
Bad news : Up at dawn for a 2.5 hour drive to rural Texas . Good news : I interview the creator of Gus , and 28 other novels ., at 10 for @ tim	Bad news : Up at dawn for a 2.5 hour drive to rural Texas . Good news : I interview the creator of Gus , and 28 other novels ., at 10 for @ tim
Aug 22 I'll be at NFL HQ with Goodell , Hallenbeck , and others . Topic : NFL ' s work to make youth sports even safer . What do they need to know	Aug 22 I'll be at NFL HQ with Goodell , Hallenbeck , and others . Topic : NFL 's work to make youth sports even safer . What do they need to know
We did a wine tasting at our Family Reunion . Each cabin was diff theme . Ours was Italian wines . # Wine http://t.co/N5PARaRUS	We did a wine tasting at our Family Reunion . Each cabin was diff theme . Ours was Italian wines . # Wine http://t.co/N5PARaRUS
I'm interviewed on Montana Public Radio today about My Life as Laura on @ thewritequestion http://t.co/e0INHPY	I'm interviewed on Montana Public Radio today about My Life as Laura on @ thewritequestion http://t.co/e0INHPY
Well I'm pretty sure my iPad is dead . Back to pen and paper notes I guess . :	Well I'm pretty sure my iPad is dead . Back to pen and paper notes I guess . :
I won the One-Second Stopwatch Game in 31 tries ! Bet you can't beat me . http://t.co/HVPJygNVuG @ jkottk	I won the One-Second Stopwatch Game in 31 tries ! Bet you can't beat me . http://t.co/HVPJygNVuG @ jkottk
Help me support @ StJude through my race ! http://t.co/mUGgUU6	Help me support @ StJude through my race ! http://t.co/mUGgUU6
I am in the @ BuzzFeed office right now and I just realized how much I want to work here	I am in the @ BuzzFeed office right now and I just realized how much I want to work here
@ colsonwhitehead Congrats !!!! Our baby is due in 2 weeks . See you on late-night , diaper-changing Twitter	@ colsonwhitehead Congrats !!!! Our baby is due in 2 weeks . See you on late-night , diaper-changing Twitter
The moment I get my degree I'm booking a flight to Cali # whoswithme ? @ jesslfeller @ LaurenC_Lux @ Ashncoll	The moment I get my degree I'm booking a flight to Cali # whoswithme ? @ jesslfeller @ LaurenC_Lux @ Ashncoll
@ bsgbryan it does more for me than I thought Id ever see a bank do & better . No brainer switching , IMO . Had it just under a month so far	@ bsgbryan it does more for me than I thought Id ever see a bank do &amp; better . No brainer switching , IMO . Had it just under a month so far
I just unlocked the Level 2 Fresh Brew badge on @ foursquare ! In it to win it ! http://t.co/SLyY8Gs	I just unlocked the Level 2  Fresh Brew  badge on @ foursquare ! In it to win it ! http://t.co/SLyY8Gs
Got an internship , leaving Kaplan ... anyone want my job	Got an internship , leaving Kaplan ... anyone want my job
I got a job ! I'm back in advertising and I couldn't be happier ... My life , in so many ways , is what I've always dreamed of . # bestmondayeve	I got a job ! I'm back in advertising and I couldn't be happier ... My life , in so many ways , is what I've always dreamed of . # bestmondayeve
@ mbutler89 for what ? Slash when did u take it ?? I absolutely love that class !!!! # bestieverha	@ mbutler89 for what ? Slash when did u take it ?? I absolutely love that class !!!! # bestieverha
Heading up to @ NapaVintners with @ pfk3 @ xbethxannx ! Last time I was up in # Napa I was too young to try the wine	Heading up to @ NapaVintners with @ pfk3 @ xbethxannx ! Last time I was up in # Napa I was too young to try the wine
@ maureenogle When I win the lottery , I'll go back to graduate school . :	@ maureenogle When I win the lottery , I'll go back to graduate school . :
RT @ LifeofaPrincess : Sometimes I speak my mind too much . But at least you know I'm telling the truth . # lifeofaprinces	RT @ LifeofaPrincess : Sometimes I speak my mind too much . But at least you know I'm telling the truth . # lifeofaprinces
I've been in Hale so long I've decided I'm switching floors every hour to change it up # cantstopstudying # muststayawak	I've been in Hale so long I've decided I'm switching floors every hour to change it up # cantstopstudying # muststayawak
@ AWomansWork I can't wait to finish MBA so I can play words w/friends . Just can't handle distraction now . MBA done in June so we'll see	@ AWomansWork I can't wait to finish MBA so I can play words w/friends . Just can't handle distraction now . MBA done in June so we'll see
I'm working every day from now til June 25th to make sure @ EdMarkey is our next MA Senator . @ SenWarren needs a partner ! # VoteEdJune25 # mase	I'm working every day from now til June 25th to make sure @ EdMarkey is our next MA Senator . @ SenWarren needs a partner ! # VoteEdJune25 # mase
RT @ erikhinton : My college paper comes through with headline of the day : Druids ' secrecy detrimental to student democracy http://t.co/ ..	RT @ erikhinton : My college paper comes through with headline of the day :  Druids ' secrecy detrimental to student democracy  http://t.co/ ..
RT @ adage : Former Tracy Locke Copywriter Jim Albright Dies http://t.co/AEw1lyhS . // RIP . I interviewed him once for the @ ntdaily	RT @ adage : Former Tracy Locke Copywriter Jim Albright Dies http://t.co/AEw1lyhS . // RIP . I interviewed him once for the @ ntdaily
This is embarrassing and the worst interview I have ever seen . What a terrible journalist . # FoxNews # islam # jesus http://t.co/uVlBtEcJQ	This is embarrassing and the worst interview I have ever seen . What a terrible journalist . # FoxNews # islam # jesus http://t.co/uVlBtEcJQ
Leaving my wonderful wonderful internship very soon . Thank you @ CorpCounsel @ TheAmLawyer & @ AmLawDaily for all the great experience	Leaving my wonderful wonderful internship very soon . Thank you @ CorpCounsel @ TheAmLawyer &amp; @ AmLawDaily for all the great experience
Got so excited about seeing @ BecLazear I forgot keys are supposed to be taken OUT of the ca	Got so excited about seeing @ BecLazear I forgot keys are supposed to be taken OUT of the ca
I just interviewed a Pearl Harbor survivor today . What did you do ? ( This is totally why I'm not an accountant	I just interviewed a Pearl Harbor survivor today . What did you do ? ( This is totally why I'm not an accountant
Wit . at TxDOT hearing on gravel road flap : 30 years ago , when my husband and I built our home , we knew we wanted to live near pavemen	Wit . at TxDOT hearing on gravel road flap : 30 years ago , when my husband and I built our home , we knew we wanted to live near pavemen
I need a topic for a # blog I'm starting up . I'm thinking just a smorgasbord of posts ... thoughts	I need a topic for a # blog I'm starting up . I'm thinking just a smorgasbord of posts ... thoughts
@ jbatsell I just saw it but I don't think I'll have a car next semester . But I will next spring , so hopefully I can apply then	@ jbatsell I just saw it but I don't think I'll have a car next semester . But I will next spring , so hopefully I can apply then
I'm having a hard time finding better editing music than classical . I'm moving right along on this latest project . # SerenityNo	I'm having a hard time finding better editing music than classical . I'm moving right along on this latest project . # SerenityNo
Just found out I got accepted to # soundSCAPEfestival in the Italian Alps this summer !! So excited ! @ abkirsten @ mezzoihnen @ ganzmat	Just found out I got accepted to # soundSCAPEfestival in the Italian Alps this summer !! So excited ! @ abkirsten @ mezzoihnen @ ganzmat
@ annaherself Calm yourself . Took me 44 years before I could stomach even the words gefilte fish . But I do make a mean matzo ball	@ annaherself Calm yourself . Took me 44 years before I could stomach even the words  gefilte fish . But I do make a mean matzo ball
En Route to New York with my fam . The journey began at 4am . And too excited to sleep	En Route to New York with my fam . The journey began at 4am . And too excited to sleep
Today ' s my 1-year @ nprds anniversary ! To celebrate , I'm typing this twee	Today 's my 1-year @ nprds anniversary ! To celebrate , I'm typing this twee
Canadian wife in London to @ nytimes : Were going to wait here until the babys born . Husband : We are ? http://t.co/a9Qla2HWV	Canadian wife in London to @ nytimes : Were going to wait here until the babys born . Husband :  We are ? http://t.co/a9Qla2HWV
just turned in my two spanish papers . # feelssogoo	just turned in my two spanish papers . # feelssogoo
@ katyp222 That sounds like a lot of fun , too ! :) My ski trip is for work ... but I'm still excited	@ katyp222 That sounds like a lot of fun , too ! :) My ski trip is for work ... but I'm still excited
Smiling gets you a job at a particular bank . - Paige Arnof-Fenn . My smiling is officially going to get me somewhere . Wahoo !! # prsabo	Smiling gets you a job at a particular bank . - Paige Arnof-Fenn . My smiling is officially going to get me somewhere . Wahoo !! # prsabo
@ hakerr91 Check the # hapcap feed . I made an announcement about progress reports yesterday	@ hakerr91 Check the # hapcap feed . I made an announcement about progress reports yesterday
@ JocoGent hey I won one of those prints , would you mind picking it up for me	@ JocoGent hey I won one of those prints , would you mind picking it up for me
Got told I was super qualified in an interview today . # waitwhat # bouttim	Got told I was  super qualified  in an interview today . # waitwhat # bouttim
Got a 95% on my first tough exam of the semester . Calls for celebration . # Oktoberfes	Got a 95% on my first tough exam of the semester . Calls for celebration . # Oktoberfes
@ GeeDee215 @ postracialist I was there all summer interning at Seattle Times . Lovely city	@ GeeDee215 @ postracialist I was there all summer interning at Seattle Times . Lovely city
Sums up my feelings on the economy when I moved back to the US from Argentina : http://bit.ly/mD9i0f # itcouldbewors	Sums up my feelings on the economy when I moved back to the US from Argentina : http://bit.ly/mD9i0f # itcouldbewors
Mimosa on the plane to start # weddingweekend off right ! Cant wait to see my girls !! # partytime http://t.co/QoyILqQlK	Mimosa on the plane to start # weddingweekend off right ! Cant wait to see my girls !! # partytime http://t.co/QoyILqQlK
Poor pause timing . Salutatorian : I'm sure you all noticed my really big test ... papers . # livetweetinggraduatio	Poor pause timing . Salutatorian :  I'm sure you all noticed my really big test ... papers . # livetweetinggraduatio
RT @ RichardEscobedo : I was a college newspaper advisor http://t.co/2UyzrOqSP	RT @ RichardEscobedo : I was a college newspaper advisor http://t.co/2UyzrOqSP
@ davidjohannes I'm at a conference in San Antonio it ' s in the hotel ! And I got tea , not coffee . :	@ davidjohannes I'm at a conference in San Antonio it 's in the hotel ! And I got tea , not coffee . :
Going on a new year ' s retreat , and , gasp , I will be internet- and phone-free for 3 whole days . If I don't see you soon , then Happy New Year	Going on a new year 's retreat , and , gasp , I will be internet- and phone-free for 3 whole days . If I don't see you soon , then Happy New Year
Very excited to be on my way to Mississippi for @ MUasb_BaySTL !	Very excited to be on my way to Mississippi for @ MUasb_BaySTL !
I'm in activity limbo-I had to tear my Mario Mushroom apart and start over so I'm discouraged with crocheting for tonight . What should I do	I'm in activity limbo-I had to tear my Mario Mushroom apart and start over so I'm discouraged with crocheting for tonight . What should I do
just got my March issue of @ cosmomagazine ! so excited :	just got my March issue of @ cosmomagazine ! so excited :
Ready to work hard with my morning warriors . Boot Camp at 6 AM starts the day with power . (@ New York Sports Club ) http://t.co/fRG9WkE	Ready to work hard with my morning warriors . Boot Camp at 6 AM starts the day with power . (@ New York Sports Club ) http://t.co/fRG9WkE
RT @ techguerilla : My goal now is to become such a badass speaker that you won't care about staring at my spittle for an hour . # DNC201	RT @ techguerilla : My goal now is to become such a badass speaker that you won't care about staring at my spittle for an hour . # DNC201
@ eligray Thank you very much for the kind words about our book ! I lived in Miami Beach for a year and worked on the book proposal there	@ eligray Thank you very much for the kind words about our book ! I lived in Miami Beach for a year and worked on the book proposal there
@ ashleywithers By far the best ones I've ever seen . I want my engagement photos to be cool like that	@ ashleywithers By far the best ones I've ever seen . I want my engagement photos to be cool like that
Oh , what'd you do yesterday ? Oh , we just won fucking homecoming !!! # aepichio # YESS	Oh , what'd you do yesterday ? Oh , we just won fucking homecoming !!! # aepichio # YESS
Attending my first @ HearstCorp master class # bennackmasterclas	Attending my first @ HearstCorp master class # bennackmasterclas
As # j2380 students post audio slideshows , I watch past student ' s excellent slideshow while writing her a grad school rec letter . # fullcircl	As # j2380 students post audio slideshows , I watch past student 's excellent slideshow while writing her a grad school rec letter . # fullcircl
End of the first week of school . Whew ! I predict XBOX w/ my kids in my immediate future	End of the first week of school . Whew ! I predict XBOX w/ my kids in my immediate future
Dreaming of cupcakes and other yummies . This little # drawing was inspired by our in class painting set up yesterday . http://t.co/6633aDDZX	Dreaming of cupcakes and other yummies . This little # drawing was inspired by our in class painting set up yesterday . http://t.co/6633aDDZX
@ hayescraze721 I doubt they'll reject you lol . And it ' s okay , I'm not extremely worried . I will be working as a secretarial assistant in th	@ hayescraze721 I doubt they'll reject you lol . And it 's okay , I'm not extremely worried . I will be working as a secretarial assistant in th
Registered my original songs with ASCAP , and I'm working on the copyrights . Lots of paperwork goes into an original album ! :	Registered my original songs with ASCAP , and I'm working on the copyrights . Lots of paperwork goes into an original album ! :
I apparently won a Nexus S at the Google talk , but I wasn't there to claim it . : -	I apparently won a Nexus S at the Google talk , but I wasn't there to claim it . : -
Cupcake card for my 2-year work anniversary ! @ Tucker & Associates http://t.co/AJ3dzdI	Cupcake card for my 2-year work anniversary ! @ Tucker &amp; Associates http://t.co/AJ3dzdI
RT @ DietCokeUS : Final exams are coming up . You know , we make a pretty good study buddy . # dietcoke http://t.co/3QsbdnE	RT @ DietCokeUS : Final exams are coming up . You know , we make a pretty good study buddy . # dietcoke http://t.co/3QsbdnE
Bring it on , 2014 . Excited to be running my 1st @ ToughMudder next year which will either end awesomely or terribly . http://t.co/SPv0bXnDY	Bring it on , 2014 . Excited to be running my 1st @ ToughMudder next year which will either end awesomely or terribly . http://t.co/SPv0bXnDY
I just became the mayor of Balch Springs on @ foursquare ! http://t.co/ROYhfK1	I just became the mayor of Balch Springs on @ foursquare ! http://t.co/ROYhfK1
Dragging my reptilian body onto the warming concrete slab , hoping dank muscles remember movement . And peony ! # spring # finall	Dragging my reptilian body onto the warming concrete slab , hoping dank muscles remember movement . And peony ! # spring # finall
@ clintlalonde I'm on the edtech committee and we just put together the BYOD policy for the school	@ clintlalonde I'm on the edtech committee and we just put together the BYOD policy for the school
One of the best July 4th I ever had was in England . The locals invited me to their Losers Party - any excuse to hoist a pint	One of the best July 4th I ever had was in England . The locals invited me to their  Losers Party  - any excuse to hoist a pint
I'm so excited for next weeks training @ IJMHQ !!! You can get involved by becoming a freedom partner at www.ijm.org/freedompartne	I'm so excited for next weeks training @ IJMHQ !!! You can get involved by becoming a freedom partner at www.ijm.org/freedompartne
We're about to watch some # pig races ! @ jdunccc is so excited . @ 2013 State Fair of Texas http://t.co/Lk9WkHgVp	We're about to watch some # pig races ! @ jdunccc is so excited . @ 2013 State Fair of Texas http://t.co/Lk9WkHgVp
RT @ peterson__scott : My report on the new chemistry in # Iran nuclear talks : ' Good start , but should temper expectations ' says @ avaez http :	RT @ peterson__scott : My report on the new chemistry in # Iran nuclear talks : ' Good start , but should temper expectations ' says @ avaez http :
My legs hurt so much from dancing at the wedding last night , will this be the final push to get into shape ? # happy2014 # patheti	My legs hurt so much from dancing at the wedding last night , will this be the final push to get into shape ? # happy2014 # patheti
Six months ago today I moved to New Hampshire . Hard to believe it has already been that long	Six months ago today I moved to New Hampshire . Hard to believe it has already been that long
. @ aaschw Hey , I trusted that was where youd move your glove ! I was trying to tap into your survival instincts . FOR THE GREATER GOOD	. @ aaschw Hey , I trusted that was where youd move your glove ! I was trying to tap into your survival instincts . FOR THE GREATER GOOD
RT @ Michael_Cohen13 : Well , the end is finally here . My farewell column for @ DOsports . It ' s been a hell of a ride : http://t.co/s7bzaRzTa	RT @ Michael_Cohen13 : Well , the end is finally here . My farewell column for @ DOsports . It 's been a hell of a ride : http://t.co/s7bzaRzTa
@ LonestarLahr YES . The last six months of college were brutal . My motivation levels were mad weak	@ LonestarLahr YES . The last six months of college were brutal . My motivation levels were mad weak
@ WomenInPR1 Was able to get my ticket for the NY Roundtable ! I'm so excited ! # pr # passio	@ WomenInPR1 Was able to get my ticket for the NY Roundtable ! I'm so excited ! # pr # passio
RT @ StateFairOfTX : Feels great to be home ! I'll see you , and best of all , you'll see me tomorrow ! 2:00 p.m. http://t.co/IzSbPQqHf	RT @ StateFairOfTX : Feels great to be home ! I'll see you , and best of all , you'll see me tomorrow ! 2:00 p.m. http://t.co/IzSbPQqHf
Wow , world class endurance athlete and colleague @ jschmit just supported my campaign for @ braincancercure . Thanks ! http://t.co/mNmSUjGsK	Wow , world class endurance athlete and colleague @ jschmit just supported my campaign for @ braincancercure . Thanks ! http://t.co/mNmSUjGsK
Staking out my position for some Fourth of July fireworks by the Hudson , although I'm exactly sure which direction http://twitpic.com/5lb2k	Staking out my position for some Fourth of July fireworks by the Hudson , although I'm exactly sure which direction http://twitpic.com/5lb2k
I received +K in linkedin from @ gowestgroup , thanks ! http://t.co/jqvgxIe	I received +K in linkedin from @ gowestgroup , thanks ! http://t.co/jqvgxIe
@ brittneydurbin Let ' s start our own firm	@ brittneydurbin Let 's start our own firm
@ veronicamagan That ' s great ! I'm working in Southern California this summer at the @ ocregister . Summer has long been here	@ veronicamagan That 's great ! I'm working in Southern California this summer at the @ ocregister . Summer has long been here
@ amalucky Doing social media for @ Glamourdotcom sounds like a dream job ! Thanks for the # FF , I'm actually a Dallas Glambassador --- so fun	@ amalucky Doing social media for @ Glamourdotcom sounds like a dream job ! Thanks for the # FF , I'm actually a Dallas Glambassador --- so fun
RT @ collegedemsofbc : Dont forget about our meeting tonight at 9 in Gasson 202 ! Well be planning for our big semester event and show a # w	RT @ collegedemsofbc : Dont forget about our meeting tonight at 9 in Gasson 202 ! Well be planning for our big semester event and show a # w
Two days in TX this week , then I'm off to tour beautiful New Mexico ! # travelPR # workperk	Two days in TX this week , then I'm off to tour beautiful New Mexico ! # travelPR # workperk
I just became the mayor of Tarrytowns Public Schools Administrative Building on @ foursquare ! http://t.co/aB6IgNO	I just became the mayor of Tarrytowns Public Schools Administrative Building on @ foursquare ! http://t.co/aB6IgNO
Just did some business on the phone with our old credit union in Rochester , and it was the most joyous customer service experience in years	Just did some business on the phone with our old credit union in Rochester , and it was the most joyous customer service experience in years
@ craignewman I started the new job on July 1 . It ' s been quite the whirlwind . Fun , though	@ craignewman I started the new job on July 1 . It 's been quite the whirlwind . Fun , though
En route to California , where I will officiate at the wedding of two of my best friends , @ krisv & @ JZarracina ... Humbled . Honored	En route to California , where I will officiate at the wedding of two of my best friends , @ krisv &amp; @ JZarracina ... Humbled . Honored
2 updates . 1 : Hosting # wjchat tmrw Breaking news customization for consumers suggest convo topics . Also : I became a dad on 10/4/2013 !!!!!	2 updates . 1 : Hosting # wjchat tmrw  Breaking news customization for consumers  suggest convo topics . Also : I became a dad on 10/4/2013 !!!!!
I'm moving to SF so we need a NYC tech reporter . This is a great job @ BloombergNews : http://t.co/oNzoonbUZ	I'm moving to SF so we need a NYC tech reporter . This is a great job @ BloombergNews : http://t.co/oNzoonbUZ
@ stiles Hah ! Then I would complain about snow . I think the answer is move to San Diego	@ stiles Hah ! Then I would complain about snow . I think the answer is move to San Diego
I'm working on a story with a group about the Texas # abortion law and need to follow a woman who needs to travel for one . Please help me	I'm working on a story with a group about the Texas # abortion law and need to follow a woman who needs to travel for one . Please help me
First day at the new job is complete . Trust me , you'll enjoy our product # FoxSports1# TakinOverTheGamw http://t.co/QSmZnMCgb	First day at the new job is complete . Trust me , you'll enjoy our product # FoxSports1# TakinOverTheGamw http://t.co/QSmZnMCgb
I mastered Animals in Spanish ! http://t.co/aMAYjc07 via @ duoling	I mastered Animals in Spanish ! http://t.co/aMAYjc07 via @ duoling
@ lifeofsacrifice I used to have one , but opted to build a PC for cost reasons . Sorely regret it . Now my money is going for school and loans	@ lifeofsacrifice I used to have one , but opted to build a PC for cost reasons . Sorely regret it . Now my money is going for school and loans
Excited to say that I'll be traveling to NC to see a Moral Monday protest w/ @ snarkyazliberal on Mon ! Ready to see this movement first-hand	Excited to say that I'll be traveling to NC to see a Moral Monday protest w/ @ snarkyazliberal on Mon ! Ready to see this movement first-hand
RT @ RealJamesWoods : @ DeaconessBlues I'm pretty proud of my career . I worked and paid taxes for forty-five years while your President orga	RT @ RealJamesWoods : @ DeaconessBlues I'm pretty proud of my career . I worked and paid taxes for forty-five years while your President orga
Getting ready for my Skype interview today !!!!!	Getting ready for my Skype interview today !!!!!
@ HaleySchultheis funnnn ! I'll be there with @ rachaelnmackin :) I'm assuming I'll run into you tomorrow too at Kelly Wearstler	@ HaleySchultheis funnnn ! I'll be there with @ rachaelnmackin :) I'm assuming I'll run into you tomorrow too at Kelly Wearstler
@ iamcrawfish I watched the 30 Rock finale . But thats probably not what you were asking	@ iamcrawfish I watched the 30 Rock finale . But thats probably not what you were asking
I won a sixth place Hearst Journalism Award for opinion writing http://bit.ly/ejGygH for this piece : http://bit.ly/962zv	I won a sixth place Hearst Journalism Award for opinion writing http://bit.ly/ejGygH for this piece : http://bit.ly/962zv
Yes , I totally use math at work . # PRlife http://t.co/gKE2wVv	Yes , I totally use math at work . # PRlife http://t.co/gKE2wVv
All I really want in life is to back ' dat ass up on a couple of thug daddies . But , I guess doctorate degree from Yale will do instead	All I really want in life is to back ' dat ass up on a couple of thug daddies . But , I guess doctorate degree from Yale will do instead
Related : Just got a tour of our new office in Emeryville . Still don't have move date finalized , but I have to say I dig the new digs	Related : Just got a tour of our new office in Emeryville . Still don't have move date finalized , but I have to say I dig the new digs
@ jesslaw That has been my worry , too ! We want to start looking next yr	@ jesslaw That has been my worry , too ! We want to start looking next yr
Packing and CTA-mapping since my travel starts in the morning for Friday ' s # JerseyShoreConf in Chicago ! So excited . See you all there	Packing and CTA-mapping since my travel starts in the morning for Friday 's # JerseyShoreConf in Chicago ! So excited . See you all there
@ intern_denise Not necessarily happy hes leaving UofL , but I think hes an absolutely terrific hire for Texas	@ intern_denise Not necessarily happy hes leaving UofL , but I think hes an absolutely terrific hire for Texas
is working in CAS . Anticipating the election tonight and blogging . I am somewhat disappointed at it only being free coffee at Starbucks	is working in CAS . Anticipating the election tonight and blogging . I am somewhat disappointed at it only being free coffee at Starbucks
@ Jess_Y_Lam I know ! I just finished yesterday , but still . Guess I have no reason not to blog excessively : -	@ Jess_Y_Lam I know ! I just finished yesterday , but still . Guess I have no reason not to blog excessively : -
RT @ jeremygilbert : Proud and excited to share my talented students Fall projects . Watch live : http://t.co/JFc85ek	RT @ jeremygilbert : Proud and excited to share my talented students Fall projects . Watch live : http://t.co/JFc85ek
@ gwenifill You're too kind and such an inspiration , thank you . Hope to visit you when I move to D.C. in a couple weeks to start w/ @ KHNews	@ gwenifill You're too kind and such an inspiration , thank you . Hope to visit you when I move to D.C. in a couple weeks to start w/ @ KHNews
Thankful that I married someone who has Dostoyevsky and 2 slinkys on his nightstand . http://t.co/9hYKyEq3A	Thankful that I married someone who has Dostoyevsky and 2 slinkys on his nightstand . http://t.co/9hYKyEq3A
Exam tomorrow , just now have the time to finish my flash cards . All 106 of them . # TurntU	Exam tomorrow , just now have the time to finish my flash cards . All 106 of them . # TurntU
@ calibadger Underground Pub and Grill , I love that place ! You work there	@ calibadger Underground Pub and Grill , I love that place ! You work there
Last 10 mile ass kicking before the big race . I'm coming for ya Nashville ! # 1Week # Run4Boston http://t.co/ojkHBcb5D	Last 10 mile ass kicking before the big race . I'm coming for ya Nashville ! # 1Week # Run4Boston http://t.co/ojkHBcb5D
Boys won 4-0 . Off to the championship game we go . # TurntU	Boys won 4-0 . Off to the championship game we go . # TurntU
RT @ collegedemsofbc : Get ready for our annual dodgeball game vs @ bcrepublicans next Wednesday at 8 in the Plex ! Tell your friends ! # mapoli	RT @ collegedemsofbc : Get ready for our annual dodgeball game vs @ bcrepublicans next Wednesday at 8 in the Plex ! Tell your friends ! # mapoli
@ RealPoshMom what can I say , the semester is over and I am in relaxation mode :	@ RealPoshMom what can I say , the semester is over and I am in relaxation mode :
@ braddomitrovich heh , wanna race ? :) J/k we have calendar board action tonight and some other potentially lengthy discussion items	@ braddomitrovich heh , wanna race ? :) J/k we have calendar board action tonight and some other potentially lengthy discussion items
@ kellidev My last final is roughly Dec . 14 . See you then	@ kellidev My last final is roughly Dec . 14 . See you then
@ CarntownRoad @ TWC_Help how'd you manage that ?! They won't even respond to my tweets	@ CarntownRoad @ TWC_Help how'd you manage that ?! They won't even respond to my tweets
@ TheRedKirby I got mugged a few years ago and my eye got super scratched up . I feel your pain bro , it ' s awful . See an optometrist	@ TheRedKirby I got mugged a few years ago and my eye got super scratched up . I feel your pain bro , it 's awful . See an optometrist
@ PLANbPR Yes so excited for the OUTRAGEOUS event @ dallasgalleria ! I love @ SteveKemble !!!! I'm whipping out my 7 inch leopard heels	@ PLANbPR Yes so excited for the OUTRAGEOUS event @ dallasgalleria ! I love @ SteveKemble !!!! I'm whipping out my 7 inch leopard heels
I'm loving this mini vacation # relaxation # nocares and my best friend @ BecLazear is so awesome for letting me stay w/ her	I'm loving this mini vacation # relaxation # nocares and my best friend @ BecLazear is so awesome for letting me stay w/ her
@ bijanstephen You make good points . I graduated at a much worse time than you , and I am doing great . All about your study and your focus	@ bijanstephen You make good points . I graduated at a much worse time than you , and I am doing great . All about your study and your focus
@ teamian I'm not sure I'd say that . Let ' s get a beer sometime in the coming weeks . Maybe a mini-HZ reunion with @ create2destroy and others	@ teamian I'm not sure I'd say that . Let 's get a beer sometime in the coming weeks . Maybe a mini-HZ reunion with @ create2destroy and others
@ MaxieMcCoy @ kat_reilly Thanks , Maxie ! Looking forward to learning a lot as I start my last semester of college in January	@ MaxieMcCoy @ kat_reilly Thanks , Maxie ! Looking forward to learning a lot as I start my last semester of college in January
RT @ JustinMCotton : did I mention only 26 days til graduation !	RT @ JustinMCotton : did I mention only 26 days til graduation !
Congrats ! @ Jamaison : I'm so honored that my new # PRSA chapter likes me . Tonight I received the @ prsadallas President ' s Award	Congrats ! @ Jamaison : I'm so honored that my new # PRSA chapter likes me . Tonight I received the @ prsadallas President 's Award
Can't believe it ' s the last @ ONE28online of my college career . Meaning : the last free snacks of my college career . http://t.co/dj1wNbk	Can't believe it 's the last @ ONE28online of my college career . Meaning : the last free snacks of my college career . http://t.co/dj1wNbk
Finished my last paper as a PhD student . Wellguess not my last paper . # stillneedtgatdissertatio	Finished my last paper as a PhD student . Wellguess not my last paper . # stillneedtgatdissertatio
@ syracuseu All signed up for my Maymester and summer capstone . Last classes ever as a Master ' s candidate ! # sadbuthapp	@ syracuseu All signed up for my Maymester and summer capstone . Last classes ever as a Master 's candidate ! # sadbuthapp
# FF to those great people helping me in my job search @ iBridgeforth @ nanciemac @ burgeoningbaker @ KarlSaka	# FF to those great people helping me in my job search @ iBridgeforth @ nanciemac @ burgeoningbaker @ KarlSaka
I'm so excited to help with the # MaybornConference . This weekend will be cool	I'm so excited to help with the # MaybornConference . This weekend will be cool
Happy to report today that @ D_Hartstein and I have successfully navigated 3 yrs of marriage . Wheres our medal ? # f	Happy to report today that @ D_Hartstein and I have successfully navigated 3 yrs of marriage . Wheres our medal ? # f
We won , 3-1 ! In spite of some horrendous refereeing ! To the finals we go ! # USAUSAUSA http://t.co/DOGjFApnK	We won , 3-1 ! In spite of some horrendous refereeing ! To the finals we go ! # USAUSAUSA http://t.co/DOGjFApnK
@ jgrovum I just moved in , finally , and I'm two streets over on 16th . Spent the rainy afternoon yesterday on 14th . very nice vib	@ jgrovum I just moved in , finally , and I'm two streets over on 16th . Spent the rainy afternoon yesterday on 14th . very nice vib
Check out the interview I did with Taxman of BREAKING ARTISTS !! :) http://t.co/ekK1tCKqBh http://t.co/1irTweqCp	Check out the interview I did with Taxman of BREAKING ARTISTS !! :) http://t.co/ekK1tCKqBh http://t.co/1irTweqCp
RT @ NorahODonnell : I've just moved locations . I've never seen anything like this in my lif	RT @ NorahODonnell : I've just moved locations . I've never seen anything like this in my lif
congrats ! @ drewshane : Just left my last class of graduate school ! Booyah ! # thuglif	congrats ! @ drewshane : Just left my last class of graduate school ! Booyah ! # thuglif
I was very honoured and humbled to win this award today. I never expected any recognition. 
